key	value
GAME_LOADING	加载中……
EXP_COUNTER_MAX	MAX
MAIN_MENU_BUTTON_SINGLEPLAY	单人游戏
MAIN_MENU_BUTTON_SINGLEPLAY_TOOLTIP	开始一局单人游戏
MAIN_MENU_BUTTON_MULTIPLAY	多人游戏
MAIN_MENU_BUTTON_MULTIPLAY_TOOLTIP	开始一局联机游戏
MAIN_MENU_BUTTON_MULTIPLAY_DISABLED_TOOLTIP	多人游戏在 Demo 中不可用
MAIN_MENU_BUTTON_SETTINGS	设置
MAIN_MENU_BUTTON_SETTINGS_TOOLTIP	修改游戏设置
MAIN_MENU_BUTTON_QUIT	退出
MAIN_MENU_BUTTON_QUIT_TOOLTIP	结束游戏
CHARACTER_SELECT_HEADER	角色选择
CHARACTER_SELECT_HEADER_GAME_MODE_SINGLEPLAYER	单人游戏
CHARACTER_SELECT_HEADER_GAME_MODE_HOST_MULTIPLAYER_PUBLIC	主持游戏（公开）
CHARACTER_SELECT_HEADER_GAME_MODE_HOST_MULTIPLAYER_FRIENDS	主持游戏（仅好友）
CHARACTER_SELECT_HEADER_GAME_MODE_HOST_MULTIPLAYER_PRIVATE	主持游戏（私人）
CHARACTER_SELECT_HEADER_GAME_MODE_JOIN_MULTIPLAYER	加入游戏
CHARACTER_SELECT_HEADER_GAME_MODE_LOBBY_QUERY	查询大厅
CHARACTER_SELECT_BUTTON_CREATE_CHARACTER	建立角色
CHARACTER_SELECT_BUTTON_DELETE_CHARACTER	删除角色
CHARACTER_SELECT_BUTTON_SELECT_CHARACTER	选择角色
CHARACTER_SELECT_BUTTON_RETURN	返回
CHARACTER_SELECT_DATA_ENTRY_EMPTY_SLOT	空槽
FORMAT_CHARACTER_SELECT_DATA_ENTRY_INFO	Lv-{0} {1} {2}
CHARACTER_SELECT_CHARACTER_DELETE_PROMPT_TEXT	输入角色名称来确认操作。
CHARACTER_SELECT_CHARACTER_DELETE_PROMPT_PLACEHOLDER_TEXT	输入昵称……
CHARACTER_SELECT_CHARACTER_DELETE_BUTTON_CONFIRM	删除角色
CHARACTER_SELECT_CHARACTER_DELETE_BUTTON_RETURN	返回
CHARACTER_CREATION_HEADER	角色创建
CHARACTER_CREATION_HEADER_RACE_NAME	种族选择
CHARACTER_CREATION_RACE_DESCRIPTOR_HEADER_INITIAL_SKILL	天赋技能
CHARACTER_CREATION_BUTTON_SET_TO_DEFAULTS	默认
CHARACTER_CREATION_CHARACTER_NAME_PLACEHOLDER_TEXT	输入名字…
CHARACTER_CREATION_BUTTON_CREATE_CHARACTER	建立角色
CHARACTER_CREATION_BUTTON_RETURN	返回
CHARACTER_CREATION_CUSTOMIZER_HEADER_COLOR	颜色
CHARACTER_CREATION_CUSTOMIZER_COLOR_BODY_HEADER	身体
CHARACTER_CREATION_CUSTOMIZER_COLOR_BODY_TEXTURE	纹理
CHARACTER_CREATION_CUSTOMIZER_COLOR_HAIR_HEADER	头发
CHARACTER_CREATION_CUSTOMIZER_COLOR_HAIR_LOCK_COLOR	锁定颜色
CHARACTER_CREATION_CUSTOMIZER_HEADER_HEAD	头部
CHARACTER_CREATION_CUSTOMIZER_HEAD_HEAD_WIDTH	头宽
CHARACTER_CREATION_CUSTOMIZER_HEAD_HEAD_MOD	修改
CHARACTER_CREATION_CUSTOMIZER_HEAD_VOICE_PITCH	声调
CHARACTER_CREATION_CUSTOMIZER_HEAD_HAIR_STYLE	头发
CHARACTER_CREATION_CUSTOMIZER_HEAD_EARS	耳朵
CHARACTER_CREATION_CUSTOMIZER_HEAD_EYES	眼睛
CHARACTER_CREATION_CUSTOMIZER_HEAD_MOUTH	嘴巴
CHARACTER_CREATION_CUSTOMIZER_HEADER_BODY	身体
CHARACTER_CREATION_CUSTOMIZER_BODY_HEIGHT	身高
CHARACTER_CREATION_CUSTOMIZER_BODY_WIDTH	身宽
CHARACTER_CREATION_CUSTOMIZER_BODY_CHEST	胸部
CHARACTER_CREATION_CUSTOMIZER_BODY_ARMS	手臂
CHARACTER_CREATION_CUSTOMIZER_BODY_BELLY	腹部
CHARACTER_CREATION_CUSTOMIZER_BODY_BOTTOM	臀部
CHARACTER_CREATION_CUSTOMIZER_BODY_TAIL	尾巴
CHARACTER_CREATION_CUSTOMIZER_BODY_TOGGLE_LEFT_HANDED	镜像身体
CHARACTER_CREATION_CUSTOMIZER_HEADER_TRAIT	Trait
CHARACTER_CREATION_CUSTOMIZER_TRAIT_EQUIPMENT	装备
CHARACTER_CREATION_CUSTOMIZER_TRAIT_WEAPON_LOADOUT	武器
CHARACTER_CREATION_CUSTOMIZER_TRAIT_GEAR_DYE	染料
CHARACTER_CREATION_CUSTOMIZER_TRAIT_ATTRIBUTES	属性
CHARACTER_CREATION_CUSTOMIZER_TRAIT_RESET_ATTRIBUTE_POINTS	重置点数
SETTINGS_TAB_BUTTON_VIDEO	显示
SETTINGS_TAB_BUTTON_AUDIO	音频
SETTINGS_TAB_BUTTON_INPUT	输入
SETTINGS_TAB_BUTTON_NETWORK	界面
SETTINGS_VIDEO_HEADER_GAME_EFFECT_SETTINGS	显示敏感设置
SETTINGS_VIDEO_CELL_PROPORTIONS_TOGGLE	限制玩家角色比例
SETTINGS_VIDEO_CELL_JIGGLE_BONES_TOGGLE	关闭暗示性骨骼绑定
SETTINGS_VIDEO_CELL_CLEAR_UNDERCLOTHES_TOGGLE	启用去除打底衣物
SETTINGS_VIDEO_HEADER_VIDEO_SETTINGS	画面设置
SETTINGS_VIDEO_CELL_FULLSCREEN_TOGGLE	全屏模式
SETTINGS_VIDEO_CELL_VERTICAL_SYNC	垂直同步/锁定60FPS
SETTINGS_VIDEO_CELL_ANISOTROPIC_FILTERING	各向异性过滤
SETTINGS_VIDEO_CELL_SCREEN_RESOLUTION	屏幕分辨率
SETTINGS_VIDEO_CELL_ANTI_ALIASING	抗锯齿
SETTINGS_VIDEO_CELL_ANTI_ALIASING_OPTION_1	禁用
SETTINGS_VIDEO_CELL_ANTI_ALIASING_OPTION_2	2倍多重采样
SETTINGS_VIDEO_CELL_ANTI_ALIASING_OPTION_3	4倍多重采样
SETTINGS_VIDEO_CELL_ANTI_ALIASING_OPTION_4	8倍多重采样
SETTINGS_VIDEO_CELL_TEXTURE_FILTERING	纹理过滤
SETTINGS_VIDEO_CELL_TEXTURE_FILTERING_OPTION_1	双线性（平滑）
SETTINGS_VIDEO_CELL_TEXTURE_FILTERING_OPTION_2	最近点插值（颗粒感）
SETTINGS_VIDEO_CELL_TEXTURE_QUALITY	纹理质量
SETTINGS_VIDEO_CELL_TEXTURE_QUALITY_OPTION_1	高
SETTINGS_VIDEO_CELL_TEXTURE_QUALITY_OPTION_2	中
SETTINGS_VIDEO_CELL_TEXTURE_QUALITY_OPTION_3	低
SETTINGS_VIDEO_CELL_TEXTURE_QUALITY_OPTION_4	非常低
SETTINGS_VIDEO_HEADER_CAMERA_SETTINGS	摄像头显示设置
SETTINGS_VIDEO_CELL_FIELD_OF_VIEW	视野FOV
SETTINGS_VIDEO_CELL_CAMERA_SMOOTHING	平滑摄像头
SETTINGS_VIDEO_CELL_CAMERA_HORIZ	摄像头X轴位置
SETTINGS_VIDEO_CELL_CAMERA_VERT	摄像头Y轴位置
SETTINGS_VIDEO_CELL_CAMERA_RENDER_DISTANCE	视野距离
SETTINGS_VIDEO_CELL_CAMERA_RENDER_DISTANCE_OPTION_1	非常近
SETTINGS_VIDEO_CELL_CAMERA_RENDER_DISTANCE_OPTION_2	近
SETTINGS_VIDEO_CELL_CAMERA_RENDER_DISTANCE_OPTION_3	远
SETTINGS_VIDEO_CELL_CAMERA_RENDER_DISTANCE_OPTION_4	非常远
SETTINGS_VIDEO_HEADER_POST_PROCESSING	后期处理
SETTINGS_VIDEO_CELL_CAMERA_BITCRUSH_SHADER	启用像素化
SETTINGS_VIDEO_CELL_CAMERA_WATER_EFFECT	启用水下扭曲着色器
SETTINGS_VIDEO_CELL_CAMERA_SHAKE	启用屏幕摇晃
SETTINGS_VIDEO_CELL_WEAPON_GLOW	关闭武器发光效果
SETTINGS_AUDIO_HEADER_AUDIO_SETTINGS	音频设置
SETTINGS_AUDIO_CELL_MASTER_VOLUME	主音量
SETTINGS_AUDIO_CELL_MUTE_APPLICATION	静音应用程序
SETTINGS_AUDIO_CELL_MUTE_MUSIC	背景音乐静音
SETTINGS_AUDIO_HEADER_AUDIO_CHANNEL_SETTINGS	音频通道
SETTINGS_AUDIO_CELL_GAME_VOLUME	游戏音量
SETTINGS_AUDIO_CELL_GUI_VOLUME	界面音量
SETTINGS_AUDIO_CELL_AMBIENCE_VOLUME	环境音量
SETTINGS_AUDIO_CELL_MUSIC_VOLUME	音乐音量
SETTINGS_AUDIO_CELL_VOICE_VOLUME	语音音量
SETTINGS_INPUT_HEADER_INPUT_SETTINGS	输入设置
SETTINGS_INPUT_CELL_AXIS_TYPE	模拟摇杆轴类型
SETTINGS_INPUT_CELL_AXIS_TYPE_OPTION_1	WASD（8向）
SETTINGS_INPUT_CELL_AXIS_TYPE_OPTION_2	Xbox
SETTINGS_INPUT_CELL_AXIS_TYPE_OPTION_3	Playstation 4
SETTINGS_INPUT_HEADER_CAMERA_CONTROL	摄像头控制
SETTINGS_INPUT_CELL_CAMERA_SENSITIVITY	摇杆敏度
SETTINGS_INPUT_CELL_INVERT_X_CAMERA_AXIS	反转 X 轴
SETTINGS_INPUT_CELL_INVERT_Y_CAMERA_AXIS	反转 Y 轴
SETTINGS_INPUT_CELL_KEYBINDING_RESET_CAMERA	重置摄像头
SETTINGS_INPUT_HEADER_MOVEMENT	移动
SETTINGS_INPUT_CELL_KEYBINDING_UP	上
SETTINGS_INPUT_CELL_KEYBINDING_DOWN	下
SETTINGS_INPUT_CELL_KEYBINDING_LEFT	左
SETTINGS_INPUT_CELL_KEYBINDING_RIGHT	右
SETTINGS_INPUT_CELL_KEYBINDING_JUMP	跳跃
SETTINGS_INPUT_CELL_KEYBINDING_DASH	冲刺
SETTINGS_INPUT_HEADER_STRAFING	横向移动
SETTINGS_INPUT_CELL_KEYBINDING_LOCK_DIRECTION	Strafe
SETTINGS_INPUT_CELL_KEYBINDING_STRAFE_MODE	Strafe / Aim Mode
SETTINGS_INPUT_CELL_KEYBINDING_STRAFE_MODE_OPTION_1	按住锁定朝向键
SETTINGS_INPUT_CELL_KEYBINDING_STRAFE_MODE_OPTION_2	切换锁定朝向键
SETTINGS_INPUT_CELL_KEYBINDING_STRAFE_WEAPON	持武器时锁定朝向
SETTINGS_INPUT_CELL_KEYBINDING_STRAFE_CASTING	使用技能时固定角色方向
SETTINGS_INPUT_HEADER_ACTION	动作
SETTINGS_INPUT_CELL_KEYBINDING_ATTACK	攻击
SETTINGS_INPUT_CELL_KEYBINDING_CHARGE_ATTACK	蓄力攻击
SETTINGS_INPUT_CELL_KEYBINDING_BLOCK	格挡
SETTINGS_INPUT_CELL_KEYBINDING_TARGET	视角锁定
SETTINGS_INPUT_CELL_KEYBINDING_INTERACT	交流
SETTINGS_INPUT_CELL_KEYBINDING_PVP_FLAG	PvP模式切换
SETTINGS_INPUT_CELL_KEYBINDING_SKILL_SLOT_01	技能槽1
SETTINGS_INPUT_CELL_KEYBINDING_SKILL_SLOT_02	技能槽2
SETTINGS_INPUT_CELL_KEYBINDING_SKILL_SLOT_03	技能槽3
SETTINGS_INPUT_CELL_KEYBINDING_SKILL_SLOT_04	技能槽4
SETTINGS_INPUT_CELL_KEYBINDING_SKILL_SLOT_05	技能槽5
SETTINGS_INPUT_CELL_KEYBINDING_SKILL_SLOT_06	技能槽6
SETTINGS_INPUT_CELL_KEYBINDING_RECALL	召回
SETTINGS_INPUT_CELL_KEYBINDING_QUICKSWAP_WEAPON	快捷切换武器
SETTINGS_INPUT_CELL_KEYBINDING_SHEATHE_WEAPON	收回/拔出武器
SETTINGS_INPUT_CELL_KEYBINDING_SIT	坐下
SETTINGS_INPUT_HEADER_CONSUMABLE_SLOTS	消耗品快捷栏
SETTINGS_INPUT_CELL_KEYBINDING_QUICK_SLOT_01	快捷栏 1
SETTINGS_INPUT_CELL_KEYBINDING_QUICK_SLOT_02	快捷栏 2
SETTINGS_INPUT_CELL_KEYBINDING_QUICK_SLOT_03	快捷栏 3
SETTINGS_INPUT_CELL_KEYBINDING_QUICK_SLOT_04	快捷栏 4
SETTINGS_INPUT_CELL_KEYBINDING_QUICK_SLOT_05	快捷栏 5
SETTINGS_INPUT_HEADER_INTERFACE	界面
SETTINGS_INPUT_CELL_KEYBINDING_HOST_CONSOLE	服务器控制台
SETTINGS_INPUT_CELL_KEYBINDING_LEXICON	打开词典
SETTINGS_INPUT_CELL_KEYBINDING_TAB_MENU	Open Tab Menu
SETTINGS_INPUT_CELL_KEYBINDING_STATS_TAB	属性界面
SETTINGS_INPUT_CELL_KEYBINDING_SKILLS_TAB	技能界面
SETTINGS_INPUT_CELL_KEYBINDING_ITEM_TAB	物品界面
SETTINGS_INPUT_CELL_KEYBINDING_QUEST_TAB	任务界面
SETTINGS_INPUT_CELL_KEYBINDING_WHO_TAB	联机页界面
SETTINGS_INPUT_CELL_KEYBINDING_HIDE_UI	隐藏游戏界面
SETTINGS_NETWORK_HEADER_UI_SETTINGS	界面设置
SETTINGS_NETWORK_CELL_LOCALYSSATION_LANGUAGE	语言
SETTINGS_NETWORK_CELL_DISPLAY_CREEP_NAMETAGS	显示敌人名字
SETTINGS_NETWORK_CELL_DISPLAY_LOCAL_NAMETAG	显示在线玩家名称
SETTINGS_NETWORK_CELL_DISPLAY_HOST_TAG	在房主的角色上显示[房主]标签
SETTINGS_NETWORK_CELL_HIDE_DUNGEON_MINIMAP	隐藏地牢小地图
SETTINGS_NETWORK_CELL_HIDE_FPS_COUNTER	隐藏帧率
SETTINGS_NETWORK_CELL_HIDE_PING_COUNTER	隐藏网络延迟
SETTINGS_NETWORK_HEADER_CLIENT_SETTINGS	客户端设置
SETTINGS_NETWORK_CELL_ENABLE_PVP_ON_MAP_ENTER	只有当 PvP 模式可用时
SETTINGS_BUTTON_RESET_TO_DEFAULTS	重置为默认设置
SETTINGS_BUTTON_RESET	重置
SETTINGS_BUTTON_CANCEL	取消
SETTINGS_BUTTON_APPLY	应用
FORMAT_EQUIP_ITEM_RARITY	[{0}]
FORMAT_EQUIP_LEVEL_REQUIREMENT	Lv-{0}
FORMAT_EQUIP_CLASS_REQUIREMENT	职业：{0}
FORMAT_EQUIP_WEAPON_CONDITION	\n<color=lime>- <color=yellow>{0}%</color> chance to apply {1}.</color>
EQUIP_TOOLTIP_TYPE_HELM	头盔（装备）
EQUIP_TOOLTIP_TYPE_CHESTPIECE	胸甲（装备）
EQUIP_TOOLTIP_TYPE_LEGGINGS	护腿（装备）
EQUIP_TOOLTIP_TYPE_CAPE	披风（装备）
EQUIP_TOOLTIP_TYPE_RING	戒指（装备）
FORMAT_EQUIP_TOOLTIP_TYPE_WEAPON	{0}（武器）
EQUIP_TOOLTIP_TYPE_SHIELD	盾牌
FORMAT_EQUIP_STATS_DAMAGE_SCALED	<color=#c5e384>（ {0} - {1} ）</color> 伤害
FORMAT_EQUIP_STATS_DAMAGE_SCALED_POWERFUL	<color=#efcc00>（ {0} - {1} )</color> 伤害
FORMAT_EQUIP_STATS_DAMAGE_COMPARE_BASE	\n<color=grey> （基础伤害: {0} - {1}）</color>
FORMAT_EQUIP_STATS_DAMAGE_UNSCALED	（{0} - {1}） 伤害
FORMAT_EQUIP_STATS_BLOCK_THRESHOLD	格挡上限：{0} 伤害
TAB_MENU_CELL_STATS_HEADER	属性
TAB_MENU_CELL_STATS_ATTRIBUTE_POINT_COUNTER	点数
TAB_MENU_CELL_STATS_BUTTON_APPLY_ATTRIBUTE_POINTS	应用
TAB_MENU_CELL_STATS_INFO_CELL_NICK_NAME	昵称
TAB_MENU_CELL_STATS_INFO_CELL_RACE_NAME	种族
TAB_MENU_CELL_STATS_INFO_CELL_CLASS_NAME	职业
TAB_MENU_CELL_STATS_INFO_CELL_LEVEL_COUNTER	等级
TAB_MENU_CELL_STATS_INFO_CELL_EXPERIENCE	经验值
TAB_MENU_CELL_STATS_INFO_CELL_MAX_HEALTH	生命值
TAB_MENU_CELL_STATS_INFO_CELL_MAX_MANA	魔力值
TAB_MENU_CELL_STATS_INFO_CELL_MAX_STAMINA	耐力值
TAB_MENU_CELL_STATS_INFO_CELL_ATTACK	物攻值
TAB_MENU_CELL_STATS_INFO_CELL_RANGED_POWER	敏攻值
TAB_MENU_CELL_STATS_INFO_CELL_PHYS_CRITICAL	物理暴击率 %
TAB_MENU_CELL_STATS_INFO_CELL_MAGIC_POW	魔攻值
TAB_MENU_CELL_STATS_INFO_CELL_MAGIC_CRIT	魔法暴击率 %
TAB_MENU_CELL_STATS_INFO_CELL_DEFENSE	物理防御力
TAB_MENU_CELL_STATS_INFO_CELL_MAGIC_DEF	魔法防御力
TAB_MENU_CELL_STATS_INFO_CELL_EVASION	闪避率 %
TAB_MENU_CELL_STATS_INFO_CELL_MOVE_SPD	移动速度 %
TAB_MENU_CELL_STATS_TOOLTIP_BASE_STAT_BEGIN	<b>基础属性：</b> <i>
TAB_MENU_CELL_STATS_TOOLTIP_BASE_STAT_END_CRIT	%</i> (暴击率 %)
TAB_MENU_CELL_STATS_TOOLTIP_BASE_STAT_END_EVASION	%</i> (闪避率 %)
TAB_MENU_CELL_STATS_TOOLTIP_BASE_STAT_FORMAT_ATTACK_POW	{0}</i> (物攻值)
TAB_MENU_CELL_STATS_TOOLTIP_BASE_STAT_FORMAT_MAX_MP	{0}</i>（魔力上限）
TAB_MENU_CELL_STATS_TOOLTIP_BASE_STAT_FORMAT_MAX_HP	{0}</i>（生命上限）
TAB_MENU_CELL_STATS_TOOLTIP_BASE_STAT_FORMAT_RANGE_POW	{0}</i>（敏攻值）
TAB_MENU_CELL_STATS_TOOLTIP_BASE_STAT_END_MAGIC_CRIT	%</i>（魔法暴击率 %）
TAB_MENU_CELL_STATS_TOOLTIP_BASE_STAT_FORMAT_MAGIC_DEF	{0}</i>（魔法防御力）
TAB_MENU_CELL_STATS_TOOLTIP_BASE_STAT_FORMAT_DEFENSE	{0}</i> (物理防御力)
TAB_MENU_CELL_STATS_TOOLTIP_BASE_STAT_FORMAT_MAGIC_POW	{0}</i> (魔攻值)
TAB_MENU_CELL_STATS_TOOLTIP_BASE_STAT_FORMAT_MAX_STAM	{0}</i> (耐力上限)
FORMAT_QUEST_REQUIRED_LEVEL	(lv-{0})
QUEST_TYPE_CLASS	（职业秘籍）
QUEST_TYPE_MASTERY	（精通卷轴）
QUEST_MENU_SUMMARY_NO_QUESTS	任务日志内没有任务。
QUEST_MENU_HEADER_UNSELECTED	选择一个任务。
FORMAT_QUEST_MENU_CELL_QUEST_LOG_COUNTER	任务日志: ({0} / {1})
FORMAT_QUEST_MENU_CELL_FINISHED_QUEST_COUNTER	完成的任务: {0}
FORMAT_QUEST_MENU_CELL_REWARD_EXP	{0} 经验值
FORMAT_QUEST_MENU_CELL_REWARD_CURRENCY	{0} 克朗
QUEST_MENU_CELL_SLOT_EMPTY	空槽
QUEST_SELECTION_MANAGER_QUEST_ACCEPT_BUTTON_ACCEPT	接受任务
QUEST_SELECTION_MANAGER_QUEST_ACCEPT_BUTTON_LOCKED	锁定的任务
QUEST_SELECTION_MANAGER_QUEST_ACCEPT_BUTTON_INCOMPLETE	未完成的任务
QUEST_SELECTION_MANAGER_QUEST_ACCEPT_BUTTON_TURN_IN	完成任务
QUEST_SELECTION_MANAGER_QUEST_ACCEPT_BUTTON_UNSELECTED	选择任务
FORMAT_QUEST_PROGRESS	{0}：( {1} / {2} )
FORMAT_QUEST_PROGRESS_CREEPS_KILLED	{0} 击杀
ITEM_LEATHER_CAP_NAME	皮革帽子
ITEM_LEATHER_CAP_DESCRIPTION	
ITEM_NEWFOLD_HALO_NAME	新手光环
ITEM_NEWFOLD_HALO_DESCRIPTION	象征新生灵魂降临世间的符印。
ITEM_FOCUS_CIRCLET_NAME	专注头环
ITEM_FOCUS_CIRCLET_DESCRIPTION	屏息凝神。
ITEM_JOURNEYMAN_SPECTACLES_NAME	老手眼镜
ITEM_JOURNEYMAN_SPECTACLES_DESCRIPTION	用于读得更卖力——现在还能染色了！
ITEM_MAGISTRATE_CIRCLET_NAME	法官头环
ITEM_MAGISTRATE_CIRCLET_DESCRIPTION	清空杂念，让心境归于平和。
ITEM_RAGE_CIRCLET_NAME	愤怒头环
ITEM_RAGE_CIRCLET_DESCRIPTION	愤怒与嫉妒之集合。
ITEM_GEISTLORD_CROWN_NAME	幽魂王冠
ITEM_GEISTLORD_CROWN_DESCRIPTION	你能承受随之而来的疯狂吗？
ITEM_NETHERCRYPT_HALO_NAME	冥墓光环
ITEM_NETHERCRYPT_HALO_DESCRIPTION	冥界被放逐者之冠。
ITEM_MITHRIL_HALO_NAME	秘银光环
ITEM_MITHRIL_HALO_DESCRIPTION	
ITEM_GLYPHGRIFT_HALO_NAME	狡诈之符光环
ITEM_GLYPHGRIFT_HALO_DESCRIPTION	
ITEM_JESTERCAST_MEMORY_NAME	若愚之智遗粹
ITEM_JESTERCAST_MEMORY_DESCRIPTION	与之为敌者，方见其愚顽。
ITEM_KNIGHTGUARD_HALO_NAME	守护骑士光环
ITEM_KNIGHTGUARD_HALO_DESCRIPTION	力量与英勇之希冀。
ITEM_GEISTLORD_EYE_NAME	幽魂之主的凝视
ITEM_GEISTLORD_EYE_DESCRIPTION	超乎理解的疯狂。
ITEM_INITIATE_SPECTACLES_NAME	学徒眼镜
ITEM_INITIATE_SPECTACLES_DESCRIPTION	用于阅读。
ITEM_CRYPTSINGE_HALO_NAME	黯墓光环
ITEM_CRYPTSINGE_HALO_DESCRIPTION	亡者之沉思。
ITEM_DIVA_CROWN_NAME	女王皇冠
ITEM_DIVA_CROWN_DESCRIPTION	由史莱姆女王佩戴的皇冠，蕴含着非凡之力。
ITEM_IRON_HALO_NAME	铁制光环
ITEM_IRON_HALO_DESCRIPTION	
ITEM_DEMICRYPT_HALO_NAME	半墓光环
ITEM_DEMICRYPT_HALO_DESCRIPTION	掉落自堕天使之身。
ITEM_ACOLYTE_HOOD_NAME	侍僧兜帽
ITEM_ACOLYTE_HOOD_DESCRIPTION	常有教徒戴着它。
ITEM_DIRE_HELM_NAME	勇战头盔
ITEM_DIRE_HELM_DESCRIPTION	它曾属于一位英勇的战士。
ITEM_WIZARD_HAT_NAME	巫师帽
ITEM_WIZARD_HAT_DESCRIPTION	
ITEM_REGAZUUL_CAPE_NAME	祖氏王家斗篷
ITEM_REGAZUUL_CAPE_DESCRIPTION	祖纳鲁达的一件尘封的遗物。
ITEM_COZY_CLOAK_NAME	保暖披风
ITEM_COZY_CLOAK_DESCRIPTION	让你在刺骨的天气下保持温暖。
ITEM_NETHERCRYPT_CLOAK_NAME	冥墓披风
ITEM_NETHERCRYPT_CLOAK_DESCRIPTION	曾用作死者的裹尸布。
ITEM_FORLORN_CLOAK_NAME	凄凉披风
ITEM_FORLORN_CLOAK_DESCRIPTION	孤独苦闷，直至永远。
ITEM_MESHLINK_CAPE_NAME	珠链丝网
ITEM_MESHLINK_CAPE_DESCRIPTION	既隐匿又轻便。
ITEM_SAGECALLER_CAPE_NAME	先贤化身
ITEM_SAGECALLER_CAPE_DESCRIPTION	披风上充盈着魔力。
ITEM_COBBLERAGE_CLOAK_NAME	撼山之势
ITEM_COBBLERAGE_CLOAK_DESCRIPTION	穿上它，你就能觉得自己像魔像一般强壮。
ITEM_DEATHWARD_CAPE_NAME	防死结界
ITEM_DEATHWARD_CAPE_DESCRIPTION	你听到骷髅图案里传来笑声。
ITEM_INITIATE_CLOAK_NAME	学徒披风
ITEM_INITIATE_CLOAK_DESCRIPTION	新的开始。
ITEM_NOKKET_CLOAK_NAME	纳克特披风
ITEM_NOKKET_CLOAK_DESCRIPTION	
ITEM_RUGGED_CLOAK_NAME	粗布披风
ITEM_RUGGED_CLOAK_DESCRIPTION	
ITEM_AERO_TOP_NAME	风行上衣
ITEM_AERO_TOP_DESCRIPTION	毕鸟通常穿的衣服。
ITEM_BUNHOST_GARB_NAME	兔女郎制服
ITEM_BUNHOST_GARB_DESCRIPTION	
ITEM_LEATHER_TOP_NAME	皮革上衣
ITEM_LEATHER_TOP_DESCRIPTION	珀尔通常穿的衣服。
ITEM_NECRO_MARROW_NAME	亡骨外装
ITEM_NECRO_MARROW_DESCRIPTION	小鬼通常穿的衣服。
ITEM_NOBLE_SHIRT_NAME	贵族衬衫
ITEM_NOBLE_SHIRT_DESCRIPTION	
ITEM_NUTSO_TOP_NAME	活力上衣
ITEM_NUTSO_TOP_DESCRIPTION	常鼠通常穿的衣服。
ITEM_SAGECLOTH_TOP_NAME	贤者上衣
ITEM_SAGECLOTH_TOP_DESCRIPTION	钴博通常穿的衣服。
ITEM_SILKEN_TOP_NAME	丝绸上衣
ITEM_SILKEN_TOP_DESCRIPTION	古老的丝绸衣物。说不定它从世界伊始就存在了...
ITEM_TEST_CHESTPIECE_NAME	测试胸甲
ITEM_TEST_CHESTPIECE_DESCRIPTION	用于测试贴图。
ITEM_VAMPIRIC_COAT_NAME	吸血鬼外衣
ITEM_VAMPIRIC_COAT_DESCRIPTION	
ITEM_DUELIST_GARB_NAME	格斗家上装
ITEM_DUELIST_GARB_DESCRIPTION	
ITEM_TATTERED_BATTLEROBE_NAME	破旧战袍
ITEM_TATTERED_BATTLEROBE_DESCRIPTION	
ITEM_WARRIOR_CHEST_NAME	战士胸甲
ITEM_WARRIOR_CHEST_DESCRIPTION	
ITEM_SLEEPERS_ROBE_NAME	睡眠长袍
ITEM_SLEEPERS_ROBE_DESCRIPTION	太困了...
ITEM_LORD_BREASTPLATE_NAME	领主胸甲
ITEM_LORD_BREASTPLATE_DESCRIPTION	向领主致敬！
ITEM_REAPSOW_GARB_NAME	噬魂制服
ITEM_REAPSOW_GARB_DESCRIPTION	潜藏起来才最令人生畏。
ITEM_WITCHLOCK_ROBE_NAME	巫术长袍
ITEM_WITCHLOCK_ROBE_DESCRIPTION	奥术师中的翘楚才配得上的长袍。
ITEM_GOLEM_CHESTPIECE_NAME	魔像胸甲
ITEM_GOLEM_CHESTPIECE_DESCRIPTION	
ITEM_NETHERCRYPT_TABARD_NAME	冥墓战袍
ITEM_NETHERCRYPT_TABARD_DESCRIPTION	
ITEM_ORNAMENTED_BATTLEROBE_NAME	华丽战袍
ITEM_ORNAMENTED_BATTLEROBE_DESCRIPTION	
ITEM_MERCENARY_VESTMENT_NAME	佣兵外衣
ITEM_MERCENARY_VESTMENT_DESCRIPTION	
ITEM_MITHRIL_CHESTPIECE_NAME	秘银胸甲
ITEM_MITHRIL_CHESTPIECE_DESCRIPTION	
ITEM_CARBUNCLE_ROBE_NAME	绯咒长袍
ITEM_CARBUNCLE_ROBE_DESCRIPTION	布料上的图案，若你仔细聆听，会发出轻微的嗡嗡声。
ITEM_FORTIFIED_VESTMENT_NAME	加固外衣
ITEM_FORTIFIED_VESTMENT_DESCRIPTION	
ITEM_CHAINSCALE_CHEST_NAME	链鳞胸甲
ITEM_CHAINSCALE_CHEST_DESCRIPTION	
ITEM_GEMVEIL_RAIMENT_NAME	镶晶护甲
ITEM_GEMVEIL_RAIMENT_DESCRIPTION	这件胸甲上镶嵌着闪烁的宝石，防御力极强。
ITEM_KING_BREASTPLATE_NAME	王家胸甲
ITEM_KING_BREASTPLATE_DESCRIPTION	跪下，向国王行礼！
ITEM_MONOLITH_CHESTPIECE_NAME	巨石魔像胸甲
ITEM_MONOLITH_CHESTPIECE_DESCRIPTION	
ITEM_REAPER_GI_NAME	死神上装
ITEM_REAPER_GI_DESCRIPTION	不死生物中暗杀者的装束。
ITEM_WITCHWIZARD_ROBE_NAME	巫术长袍
ITEM_WITCHWIZARD_ROBE_DESCRIPTION	只属于精英奥术师中的精英的长袍。
ITEM_SLIMECRUST_CHEST_NAME	黏锈胸甲
ITEM_SLIMECRUST_CHEST_DESCRIPTION	破裂、侵蚀，由黏液联结着不至于散架。
ITEM_WORN_ROBE_NAME	破旧长袍
ITEM_WORN_ROBE_DESCRIPTION	显然已经被穿戴过很多次了。
ITEM_CHAINMAIL_GUARD_NAME	护卫锁甲
ITEM_CHAINMAIL_GUARD_DESCRIPTION	
ITEM_BERSERKER_CHESTPIECE_NAME	狂战士胸甲
ITEM_BERSERKER_CHESTPIECE_DESCRIPTION	
ITEM_FUGUEFALL_DUSTER_NAME	迷律风衣
ITEM_FUGUEFALL_DUSTER_DESCRIPTION	
ITEM_MAGILORD_OVERALLS_NAME	魔法领主套装
ITEM_MAGILORD_OVERALLS_DESCRIPTION	古代虔诚的秘术师们曾在仪式中身着这套衣物。
ITEM_JOURNEYMAN_VEST_NAME	老手背心
ITEM_JOURNEYMAN_VEST_DESCRIPTION	
ITEM_POACHER_CLOTH_NAME	偷猎者上衣
ITEM_POACHER_CLOTH_DESCRIPTION	只裹住了重要部位。
ITEM_GHOSTLY_TABARD_NAME	幽灵战袍
ITEM_GHOSTLY_TABARD_DESCRIPTION	
ITEM_CRYPTSINGE_CHEST_NAME	黯墓胸甲
ITEM_CRYPTSINGE_CHEST_DESCRIPTION	
ITEM_SLIMEK_CHEST_NAME	史莱米库胸甲
ITEM_SLIMEK_CHEST_DESCRIPTION	足够坚固，能承受更多的伤害。
ITEM_IRON_CHESTPIECE_NAME	铁制胸甲
ITEM_IRON_CHESTPIECE_DESCRIPTION	
ITEM_AERO_PANTS_NAME	风行长裤
ITEM_AERO_PANTS_DESCRIPTION	毕鸟通常穿的衣服。
ITEM_BUNHOST_LEGGINGS_NAME	兔女郎紧身裤
ITEM_BUNHOST_LEGGINGS_DESCRIPTION	
ITEM_LEATHER_BRITCHES_NAME	皮革长裤
ITEM_LEATHER_BRITCHES_DESCRIPTION	珀尔通常穿的衣服。
ITEM_NECRO_CAUSTICS_NAME	亡骨护胫
ITEM_NECRO_CAUSTICS_DESCRIPTION	小鬼通常穿的衣服。
ITEM_NOBLE_PANTS_NAME	贵族长裤
ITEM_NOBLE_PANTS_DESCRIPTION	
ITEM_NUTSO_PANTS_NAME	活力长裤
ITEM_NUTSO_PANTS_DESCRIPTION	常鼠通常穿的衣服。
ITEM_SAGECLOTH_SHORTS_NAME	贤者短裤
ITEM_SAGECLOTH_SHORTS_DESCRIPTION	钴博通常穿的衣服。
ITEM_SILKEN_LOINCLOTH_NAME	丝绸缠腰
ITEM_SILKEN_LOINCLOTH_DESCRIPTION	古老的缠腰布。
ITEM_TEST_PANTS_NAME	测试长裤
ITEM_TEST_PANTS_DESCRIPTION	用于测试贴图。
ITEM_VAMPIRIC_LEGGINGS_NAME	吸血鬼裤子
ITEM_VAMPIRIC_LEGGINGS_DESCRIPTION	
ITEM_SASH_LEGGINGS_NAME	系腰紧身裤
ITEM_SASH_LEGGINGS_DESCRIPTION	够紧。
ITEM_WARRIOR_LEGGINGS_NAME	战士护腿
ITEM_WARRIOR_LEGGINGS_DESCRIPTION	
ITEM_LORD_GREAVES_NAME	领主腿甲
ITEM_LORD_GREAVES_DESCRIPTION	您的裤子，领主？
ITEM_REAPSOW_PANTS_NAME	噬魂长裤
ITEM_REAPSOW_PANTS_DESCRIPTION	
ITEM_WITCHLOCK_LOINCLOTH_NAME	巫术缠腰
ITEM_WITCHLOCK_LOINCLOTH_DESCRIPTION	
ITEM_CHAINMAIL_LEGGINGS_NAME	锁甲护腿
ITEM_CHAINMAIL_LEGGINGS_DESCRIPTION	
ITEM_MERCENARY_LEGGINGS_NAME	佣兵裤子
ITEM_MERCENARY_LEGGINGS_DESCRIPTION	
ITEM_DARKCLOTH_PANTS_NAME	暗色长裤
ITEM_DARKCLOTH_PANTS_DESCRIPTION	
ITEM_STRIDEBOND_PANTS_NAME	奔行长裤
ITEM_STRIDEBOND_PANTS_DESCRIPTION	
ITEM_KING_GREAVES_NAME	王家腿甲
ITEM_KING_GREAVES_DESCRIPTION	您的裤子，陛下？
ITEM_REAPER_LEGGINGS_NAME	死神护腿
ITEM_REAPER_LEGGINGS_DESCRIPTION	
ITEM_WITCHWIZARD_GARTERBELT_NAME	巫师吊带
ITEM_WITCHWIZARD_GARTERBELT_DESCRIPTION	
ITEM_SLIMECRUST_LEGGINGS_NAME	黏锈护腿
ITEM_SLIMECRUST_LEGGINGS_DESCRIPTION	被史莱姆黏液浸透了。
ITEM_BERSERKER_LEGGINGS_NAME	狂战士护腿
ITEM_BERSERKER_LEGGINGS_DESCRIPTION	
ITEM_FUGUEFALL_PANTS_NAME	迷律长裤
ITEM_FUGUEFALL_PANTS_DESCRIPTION	
ITEM_MAGILORD_BOOTS_NAME	魔法领主靴子
ITEM_MAGILORD_BOOTS_DESCRIPTION	让你的脚趾保持温暖。
ITEM_GHOSTLY_LEGWRAPS_NAME	幽灵裹腿
ITEM_GHOSTLY_LEGWRAPS_DESCRIPTION	穿上这个后你感觉你的腿麻木了。
ITEM_JOURNEYMAN_SHORTS_NAME	老手短裤
ITEM_JOURNEYMAN_SHORTS_DESCRIPTION	
ITEM_SLIMEK_LEGGINGS_NAME	史莱米库裤子
ITEM_SLIMEK_LEGGINGS_DESCRIPTION	被史莱米库黏液浸透了。
ITEM_JOURNEYMAN_LEGGINGS_NAME	老手裤子
ITEM_JOURNEYMAN_LEGGINGS_DESCRIPTION	
ITEM_WOODEN_SHIELD_NAME	木制盾牌
ITEM_WOODEN_SHIELD_DESCRIPTION	
ITEM_IRIS_SHIELD_NAME	慧眼盾牌
ITEM_IRIS_SHIELD_DESCRIPTION	用于祈求秘法之泪的法器。
ITEM_OMEN_SHIELD_NAME	噩兆盾牌
ITEM_OMEN_SHIELD_DESCRIPTION	盾面上的图案令人不安。
ITEM_NETHERCRYPT_SHIELD_NAME	冥墓盾牌
ITEM_NETHERCRYPT_SHIELD_DESCRIPTION	上面扭曲地刻着冥界的纹章。
ITEM_MITHRIL_SHIELD_NAME	秘银盾牌
ITEM_MITHRIL_SHIELD_DESCRIPTION	
ITEM_RUSTWEARY_SHIELD_NAME	戎斑锈盾
ITEM_RUSTWEARY_SHIELD_DESCRIPTION	盾面纹着的脸忧心忡忡。
ITEM_RUSTWISE_SHIELD_NAME	灵纹锈盾
ITEM_RUSTWISE_SHIELD_DESCRIPTION	盾面纹着的脸自信满满。
ITEM_CRYPT_BUCKLER_NAME	墓穴圆盾
ITEM_CRYPT_BUCKLER_DESCRIPTION	它曾随着古代战士征战四方。
ITEM_DEMICRYPT_BUCKLER_NAME	半墓圆盾
ITEM_DEMICRYPT_BUCKLER_DESCRIPTION	盾面上刻有古代石棺的纹章。
ITEM_IRON_SHIELD_NAME	铁制盾牌
ITEM_IRON_SHIELD_DESCRIPTION	
ITEM_OLD_RING_NAME	陈年戒指
ITEM_OLD_RING_DESCRIPTION	
ITEM_RING_OF_AMBITION_NAME	野心之戒
ITEM_RING_OF_AMBITION_DESCRIPTION	你总觉得这戒指肯定有哪里很特别。
ITEM_TEST_RING_NAME	测试戒指
ITEM_TEST_RING_DESCRIPTION	你曾经能够获得它。如果你有这东西，那你一定玩很久了...
ITEM_GEISTLORD_RING_NAME	幽魂之戒
ITEM_GEISTLORD_RING_DESCRIPTION	祖纳鲁达回忆的低语在你的灵魂中回荡。
ITEM_STUDENTS_RING_NAME	学者之戒
ITEM_STUDENTS_RING_DESCRIPTION	精益求精！
ITEM_PEARLPOND_RING_NAME	珠池之戒
ITEM_PEARLPOND_RING_DESCRIPTION	珍珠轻响，带来心灵的宁静与明澈。
ITEM_SLITHERWRAITH_RING_NAME	鬼蛇之戒
ITEM_SLITHERWRAITH_RING_DESCRIPTION	悄悄滑过门扉。
ITEM_ORBOS_RING_NAME	衔尾蛇戒
ITEM_ORBOS_RING_DESCRIPTION	
ITEM_JADETROUT_RING_NAME	玉鳟之戒
ITEM_JADETROUT_RING_DESCRIPTION	鱼尾快速地摇摆着。
ITEM_VALOR_RING_NAME	勇气之戒
ITEM_VALOR_RING_DESCRIPTION	
ITEM_GEISTLORD_BAND_NAME	幽魂手镯
ITEM_GEISTLORD_BAND_DESCRIPTION	卡鲁兹回忆的低语在你的灵魂中回荡。
ITEM_EARTHWOKEN_RING_NAME	地鸣之戒
ITEM_EARTHWOKEN_RING_DESCRIPTION	镶嵌的宝珠各个透着光，犹如撼地巨像身上的宝石。
ITEM_AMBERSQUIRE_RING_NAME	扈从琥珀之戒
ITEM_AMBERSQUIRE_RING_DESCRIPTION	坚如钢钉。
ITEM_EMERALDFOCUS_RING_NAME	屏息绿宝石戒
ITEM_EMERALDFOCUS_RING_DESCRIPTION	即使在远处也能看见绿宝石闪烁。
ITEM_SAPPHIREWEAVE_RING_NAME	施术蓝宝石戒
ITEM_SAPPHIREWEAVE_RING_DESCRIPTION	海浪之声在你的耳边空鸣。
ITEM_WOOD_DAGGERS_NAME	木制匕首
ITEM_WOOD_DAGGERS_DESCRIPTION	
ITEM_RUNIC_KATARS_NAME	符文拳刃
ITEM_RUNIC_KATARS_DESCRIPTION	由一位善用酷刑的施虐者所铸造。
ITEM_GEISTLORD_CLAWS_NAME	幽魂利爪
ITEM_GEISTLORD_CLAWS_DESCRIPTION	能够生生撕碎哀嚎的亡灵。
ITEM_HELLSLUDGE_SHIVS_NAME	狱火耳刃
ITEM_HELLSLUDGE_SHIVS_DESCRIPTION	太烫了！慎碰！
ITEM_MITHRIL_KATARS_NAME	秘银拳刃
ITEM_MITHRIL_KATARS_DESCRIPTION	
ITEM_SERRATED_KNUCKLES_NAME	锯齿指虎
ITEM_SERRATED_KNUCKLES_DESCRIPTION	
ITEM_FROSTBITE_CLAWS_NAME	极寒利爪
ITEM_FROSTBITE_CLAWS_DESCRIPTION	阴冷刺骨…
ITEM_GOLEMFIST_KATARS_NAME	巨像拳刃
ITEM_GOLEMFIST_KATARS_DESCRIPTION	咣！
ITEM_SLIMECRUST_KATARS_NAME	黏锈拳刃
ITEM_SLIMECRUST_KATARS_DESCRIPTION	曾经是锋利的铁制拳刃，如今却被史莱姆腐蚀成了钝器。
ITEM_SLIMEK_SHIVS_NAME	史莱米库耳刃
ITEM_SLIMEK_SHIVS_DESCRIPTION	这对史莱米库的大耳朵看着似乎能当兵器来使…
ITEM_DEATHGEL_SHIVS_NAME	腐臭耳刃
ITEM_DEATHGEL_SHIVS_DESCRIPTION	腐烂且致命，一对锐利的腐臭史莱姆双耳。
ITEM_IRON_KATARS_NAME	铁拳刃
ITEM_IRON_KATARS_DESCRIPTION	
ITEM_WOODEN_BOW_NAME	木弓
ITEM_WOODEN_BOW_DESCRIPTION	
ITEM_MENACE_BOW_NAME	斥敌威弓
ITEM_MENACE_BOW_DESCRIPTION	哪怕只是手握这张弓，你也能感到自己的动作愈加迅捷。
ITEM_PETRIFIED_BOW_NAME	石化古弓
ITEM_PETRIFIED_BOW_DESCRIPTION	这张弓上囚禁着诸多被诅咒的亡魂。
ITEM_NECROROYAL_BOW_NAME	尸皇弓
ITEM_NECROROYAL_BOW_DESCRIPTION	
ITEM_MITHRIL_BOW_NAME	秘银弓
ITEM_MITHRIL_BOW_DESCRIPTION	
ITEM_SERRATED_LONGBOW_NAME	锯齿长弓
ITEM_SERRATED_LONGBOW_DESCRIPTION	弓臂尖锐而扭曲。所射出的箭矢能够贯穿多个敌人。
ITEM_COLDGEIST_BOW_NAME	阴魂弓
ITEM_COLDGEIST_BOW_DESCRIPTION	能够给予冻死的亡魂堙灭作为解脱。
ITEM_CRYPT_BOW_NAME	墓穴弓
ITEM_CRYPT_BOW_DESCRIPTION	若不是有粘稠如胶般的煤灰加以联结，这张骨弓早散了架。
ITEM_DEMICRYPT_BOW_NAME	半墓弓
ITEM_DEMICRYPT_BOW_DESCRIPTION	构成这张弓的骸骨原主似乎刚死还没多久。
ITEM_IRON_BOW_NAME	铁弓
ITEM_IRON_BOW_DESCRIPTION	
ITEM_MEKSPIKE_BOW_NAME	猪猪突刺弓
ITEM_MEKSPIKE_BOW_DESCRIPTION	这张弓的设计与突突猪的身体结构有异曲同工之处。
ITEM_WOOD_SWORD_NAME	木剑
ITEM_WOOD_SWORD_DESCRIPTION	
ITEM_DAWN_MACE_NAME	曙光战锤
ITEM_DAWN_MACE_DESCRIPTION	一锤不够那就再来一锤。
ITEM_RUDE_BLADE_NAME	粗陋之剑
ITEM_RUDE_BLADE_DESCRIPTION	可真有你的，吃饱了撑着杀我干嘛啊？
ITEM_VILE_BLADE_NAME	极恶之剑
ITEM_VILE_BLADE_DESCRIPTION	一把比粗陋之剑还要再…过分些的宝剑。
ITEM_NETHERCRYPT_BLADE_NAME	冥墓剑
ITEM_NETHERCRYPT_BLADE_DESCRIPTION	剑身中充斥着冥界的魔力，因而被其扭曲。
ITEM_MITHRIL_SWORD_NAME	秘银剑
ITEM_MITHRIL_SWORD_DESCRIPTION	
ITEM_SERRATED_BLADE_NAME	锯齿剑
ITEM_SERRATED_BLADE_DESCRIPTION	
ITEM_COLDGEIST_BLADE_NAME	阴魂剑
ITEM_COLDGEIST_BLADE_DESCRIPTION	由被侵染的寒霜铸成，古时曾为贤者们的礼仪佩剑。
ITEM_SLIMECRUST_BLADE_NAME	黏锈剑
ITEM_SLIMECRUST_BLADE_DESCRIPTION	勉强还能看出这是把铁剑，但剑刃已被史莱姆腐蚀钝得不像样子。
ITEM_CRYPT_BLADE_NAME	墓穴剑
ITEM_CRYPT_BLADE_DESCRIPTION	锋利的骨刃取自一位狂徒的遗骨。
ITEM_GILDED_SWORD_NAME	镀金剑
ITEM_GILDED_SWORD_DESCRIPTION	古老的刃口早已破损，但它依旧锋利，好歹还能防身。
ITEM_IRON_SWORD_NAME	铁剑
ITEM_IRON_SWORD_DESCRIPTION	
ITEM_DEMICRYPT_BLADE_NAME	半墓剑
ITEM_DEMICRYPT_BLADE_DESCRIPTION	死者的低语被禁锢于这把剑中。
ITEM_WOOD_HAMMER_NAME	木锤
ITEM_WOOD_HAMMER_DESCRIPTION	
ITEM_CRYPT_POUNDER_NAME	墓穴重锤
ITEM_CRYPT_POUNDER_DESCRIPTION	由罪人们的骸骨制成。
ITEM_STONE_GREATBLADE_NAME	石制大剑
ITEM_STONE_GREATBLADE_DESCRIPTION	
ITEM_POLTERGEIST_SCYTHE_NAME	喧闹幽魂镰刀
ITEM_POLTERGEIST_SCYTHE_DESCRIPTION	各种幽魂所使用的镰刀中的至上佳品。
ITEM_MITHRIL_GREATSWORD_NAME	秘银巨剑
ITEM_MITHRIL_GREATSWORD_DESCRIPTION	
ITEM_DEADWOOD_AXE_NAME	腐木重斧
ITEM_DEADWOOD_AXE_DESCRIPTION	这把斧头曾深深的嵌在一只腐木妖上。不论来头还是缘由都不为人所知。
ITEM_COLDGEIST_PUNISHER_NAME	阴魂惩戒者
ITEM_COLDGEIST_PUNISHER_DESCRIPTION	斧刃上所结的是永冻的坚冰。
ITEM_QUAKE_PUMMELER_NAME	撼地巨锤
ITEM_QUAKE_PUMMELER_DESCRIPTION	将他们全数碾碎，永劫不复。
ITEM_MINI_GEIST_SCYTHE_NAME	小幽魂镰刀
ITEM_MINI_GEIST_SCYTHE_DESCRIPTION	小幽魂身边唯一的伴侣。刀刃散发着一股骇人的气息。
ITEM_SLIMEK_AXEHAMMER_NAME	史莱米库斧锤
ITEM_SLIMEK_AXEHAMMER_DESCRIPTION	一柄被腐蚀得不像样子的铁制斧锤。手柄滑腻腻的，想握牢有些难度。
ITEM_IRON_AXEHAMMER_NAME	铁斧锤
ITEM_IRON_AXEHAMMER_DESCRIPTION	
ITEM_GEIST_SCYTHE_NAME	幽魂镰刀
ITEM_GEIST_SCYTHE_DESCRIPTION	死者们被斩下的灵魂在这柄镰刀中颤抖，共鸣。
ITEM_MEKSPEAR_NAME	突突长枪
ITEM_MEKSPEAR_DESCRIPTION	顶着一头突突猪的角的阔头枪。还算趁手。
ITEM_SINNER_BARDICHE_NAME	断罪长柄刀
ITEM_SINNER_BARDICHE_DESCRIPTION	这柄武器上浸满了罪人们的鲜血。
ITEM_NECROROYAL_HALBERD_NAME	尸皇斧枪
ITEM_NECROROYAL_HALBERD_DESCRIPTION	不死生物中的皇家卫士们所用的兵器。
ITEM_MITHRIL_HALBERD_NAME	秘银斧枪
ITEM_MITHRIL_HALBERD_DESCRIPTION	
ITEM_RAGESPEAR_NAME	愤愤长枪
ITEM_RAGESPEAR_DESCRIPTION	长枪尖口上看着似乎沾满了血迹，但其实是由某种腐蚀性的素材所铸。
ITEM_SERRATED_SPEAR_NAME	锯齿长枪
ITEM_SERRATED_SPEAR_DESCRIPTION	
ITEM_WOOD_SPEAR_NAME	木枪
ITEM_WOOD_SPEAR_DESCRIPTION	
ITEM_IRON_SPEAR_NAME	铁枪
ITEM_IRON_SPEAR_DESCRIPTION	
ITEM_CRYPTSINGE_HALBERD_NAME	黯墓斧枪
ITEM_CRYPTSINGE_HALBERD_DESCRIPTION	一刺一戳，即便是不死怪物也得退让三分。
ITEM_WOOD_SCEPTER_NAME	木法杖
ITEM_WOOD_SCEPTER_DESCRIPTION	
ITEM_CRYO_CANE_NAME	寒冰之杖
ITEM_CRYO_CANE_DESCRIPTION	予他们以霜冻。
ITEM_SLIME_DIVA_BATON_NAME	史莱姆女王的指挥棒
ITEM_SLIME_DIVA_BATON_DESCRIPTION	只有史莱姆女王本尊才能真正发挥出这根指挥棒的全部力量。
ITEM_PYRE_CANE_NAME	焚烧之杖
ITEM_PYRE_CANE_DESCRIPTION	予他们以火灼。
ITEM_WIZWAND_NAME	巫巫法杖
ITEM_WIZWAND_DESCRIPTION	噼里啪啦，劈头盖脸。
ITEM_NETHERCRYPT_BAUBLE_NAME	冥墓手杖
ITEM_NETHERCRYPT_BAUBLE_DESCRIPTION	这畸形的头骨令人胆寒得难以描述。
ITEM_MITHRIL_SCEPTER_NAME	秘银法杖
ITEM_MITHRIL_SCEPTER_DESCRIPTION	
ITEM_AQUAPETAL_STAFF_NAME	水花法杖
ITEM_AQUAPETAL_STAFF_DESCRIPTION	
ITEM_FLAMEPETAL_STAFF_NAME	火花法杖
ITEM_FLAMEPETAL_STAFF_DESCRIPTION	
ITEM_SPLITBARK_SCEPTER_NAME	断枝法杖
ITEM_SPLITBARK_SCEPTER_DESCRIPTION	其上嵌着的乳白色宝石散发着暖意。
ITEM_MARROW_BAUBLE_NAME	骨髓手杖
ITEM_MARROW_BAUBLE_DESCRIPTION	这会是谁的头骨呢？
ITEM_IRON_SCEPTER_NAME	铁法杖
ITEM_IRON_SCEPTER_DESCRIPTION	
ITEM_DEMICRYPT_BAUBLE_NAME	半墓手杖
ITEM_DEMICRYPT_BAUBLE_DESCRIPTION	这头骨怎么看都觉得像假的。
ITEM_CRYPTCALL_BELL_NAME	墓穴嚎哭铃
ITEM_CRYPTCALL_BELL_DESCRIPTION	为逝者献上悼亡的钟声。
ITEM_MITHRIL_BELL_NAME	秘银铃铛
ITEM_MITHRIL_BELL_DESCRIPTION	
ITEM_COLDGEIST_FROSTCALLER_NAME	阴魂降霜铃
ITEM_COLDGEIST_FROSTCALLER_DESCRIPTION	能够以毛骨悚然的音色唤醒长眠的幽魂之主。
ITEM_COLOSSUS_TONE_NAME	巨像之音
ITEM_COLOSSUS_TONE_DESCRIPTION	这柄铃铛中嵌着一尊撼地巨像的无数碎块。
ITEM_WOODEN_BELL_NAME	木制铃铛
ITEM_WOODEN_BELL_DESCRIPTION	虽然这杆武器是木制的，但它的铃声有如金属制品般铿锵有力。
ITEM_IRON_BELL_NAME	铁制铃铛
ITEM_IRON_BELL_DESCRIPTION	
ITEM_TOME_OF_THE_BANDIT_NAME	盗贼秘籍
ITEM_TOME_OF_THE_BANDIT_DESCRIPTION	<color=lime>只能在安全区使用</color>\n\n阅读此秘籍可以使你习得<color=lime>灵巧系的盗贼职业</color>同时还会重置并返还你的所有技能点，此后无法更改为其他职业。
ITEM_TOME_OF_THE_FIGHTER_NAME	战士秘籍
ITEM_TOME_OF_THE_FIGHTER_DESCRIPTION	<color=lime>只能在安全区使用</color>\n\n阅读此秘籍可以使你习得<color=red>力量系的战士职业</color>同时还会重置并返还你的所有技能点，此后无法更改为其他职业。
ITEM_TOME_OF_THE_MYSTIC_NAME	秘术师秘籍
ITEM_TOME_OF_THE_MYSTIC_DESCRIPTION	<color=lime>只能在安全区使用</color>\n\n阅读此秘籍可以使你习得<color=cyan>智力系的秘术师职业</color>同时还会重置并返还你的所有技能点，此后无法更改为其他职业。
ITEM_BLUE_DYE_NAME	蓝色染料
ITEM_BLUE_DYE_DESCRIPTION	一小瓶蓝色染料，可以将你的装备染成蓝色。
ITEM_GREEN_DYE_NAME	绿色染料
ITEM_GREEN_DYE_DESCRIPTION	一小瓶绿色染料，可以将你的装备染成绿色。
ITEM_GREY_DYE_NAME	灰色染料
ITEM_GREY_DYE_DESCRIPTION	一小瓶灰色染料，可以将你的装备染成灰色。
ITEM_RED_DYE_NAME	红色染料
ITEM_RED_DYE_DESCRIPTION	一小瓶红色染料，可以将你的装备染成红色。
ITEM_SKILL_SCROLL_ALACRITY_NAME	技能卷轴（轻捷）
ITEM_SKILL_SCROLL_ALACRITY_DESCRIPTION	使阅读者习得轻捷。
ITEM_SKILL_SCROLL_CRYO_NEEDLE_NAME	技能卷轴（寒冰尖刺）
ITEM_SKILL_SCROLL_CRYO_NEEDLE_DESCRIPTION	使阅读者习得寒冰尖刺。
ITEM_SKILL_SCROLL_EXECUTE_NAME	技能卷轴（处决）
ITEM_SKILL_SCROLL_EXECUTE_DESCRIPTION	使阅读者习得处决。
ITEM_SKILL_SCROLL_FIREBALL_NAME	技能卷轴（火球术）
ITEM_SKILL_SCROLL_FIREBALL_DESCRIPTION	使阅读者习得火球术。
ITEM_SKILL_SCROLL_INNER_FOCUS_NAME	技能卷轴（聚精会神）
ITEM_SKILL_SCROLL_INNER_FOCUS_DESCRIPTION	使阅读者习得聚精会神。
ITEM_SKILL_SCROLL_LEG_UP_NAME	技能卷轴（飞毛腿）
ITEM_SKILL_SCROLL_LEG_UP_DESCRIPTION	使阅读者习得飞毛腿。
ITEM_SKILL_SCROLL_SIPHON_LEECH_NAME	技能卷轴（虹吸血蛭）
ITEM_SKILL_SCROLL_SIPHON_LEECH_DESCRIPTION	使阅读者习得虹吸血蛭。
ITEM_SKILL_SCROLL_SPIRE_NAME	技能卷轴（尖刺术）
ITEM_SKILL_SCROLL_SPIRE_DESCRIPTION	使阅读者习得尖刺术。
ITEM_SKILL_SCROLL_SPREAD_SHOT_NAME	技能卷轴（分裂射击）
ITEM_SKILL_SCROLL_SPREAD_SHOT_DESCRIPTION	使阅读者习得分裂射击。
ITEM_SKILL_SCROLL_STURDY_NAME	技能卷轴（结实）
ITEM_SKILL_SCROLL_STURDY_DESCRIPTION	使阅读者习得结实。
ITEM_SKILL_SCROLL_BELL_MASTERY_NAME	技能卷轴（铃铛精通）
ITEM_SKILL_SCROLL_BELL_MASTERY_DESCRIPTION	使阅读者习得铃铛精通。
ITEM_SKILL_SCROLL_HEAVY_MELEE_MASTERY_NAME	技能卷轴（重武器精通）
ITEM_SKILL_SCROLL_HEAVY_MELEE_MASTERY_DESCRIPTION	使阅读者习得重武器精通。
ITEM_SKILL_SCROLL_KATAR_MASTERY_NAME	技能卷轴（拳剑精通）
ITEM_SKILL_SCROLL_KATAR_MASTERY_DESCRIPTION	使阅读者习得拳剑精通。
ITEM_SKILL_SCROLL_MELEE_MASTERY_NAME	技能卷轴（轻武器精通）
ITEM_SKILL_SCROLL_MELEE_MASTERY_DESCRIPTION	使阅读者习得轻武器精通。
ITEM_SKILL_SCROLL_POLEARM_MASTERY_NAME	技能卷轴（长兵精通）
ITEM_SKILL_SCROLL_POLEARM_MASTERY_DESCRIPTION	使阅读者习得长兵精通。
ITEM_SKILL_SCROLL_RANGED_MASTERY_NAME	技能卷轴（远程精通）
ITEM_SKILL_SCROLL_RANGED_MASTERY_DESCRIPTION	使阅读者习得远程精通。
ITEM_SKILL_SCROLL_SCEPTER_MASTERY_NAME	技能卷轴（法杖精通）
ITEM_SKILL_SCROLL_SCEPTER_MASTERY_DESCRIPTION	使阅读者习得法杖精通。
ITEM_SKILL_SCROLL_DIVINE_NAME	技能卷轴（圣域）
ITEM_SKILL_SCROLL_DIVINE_DESCRIPTION	使阅读者习得圣域。
ITEM_SKILL_SCROLL_LIFE_TAP_NAME	技能卷轴（生命转换）
ITEM_SKILL_SCROLL_LIFE_TAP_DESCRIPTION	使阅读者习得生命转换。
ITEM_BUNBAG_NAME	袋装疗膏
ITEM_BUNBAG_DESCRIPTION	小小的一瓶治疗药膏，不过聊胜于无。
ITEM_BUNJAR_NAME	罐装疗膏
ITEM_BUNJAR_DESCRIPTION	一大瓶治疗药膏。
ITEM_BUNPOT_NAME	碗装疗膏
ITEM_BUNPOT_DESCRIPTION	一小瓶治疗药膏。
ITEM_CARROT_CAKE_NAME	胡萝卜蛋糕
ITEM_CARROT_CAKE_DESCRIPTION	圣地里常常出现的美味小吃。
ITEM_MAGICLOVE_NAME	魔力果
ITEM_MAGICLOVE_DESCRIPTION	滋养心灵的一大瓣花瓣。
ITEM_MAGIFLOWER_NAME	魔力花
ITEM_MAGIFLOWER_DESCRIPTION	滋养心灵的一大朵花。
ITEM_MAGILEAF_NAME	魔力叶
ITEM_MAGILEAF_DESCRIPTION	滋养心灵的一小片叶子。
ITEM_SPECTRAL_POWDER_NAME	隐身粉末
ITEM_SPECTRAL_POWDER_DESCRIPTION	强效的幽灵物质混合物，令使用者短暂消失。
ITEM_STAMSTAR_NAME	耐力星
ITEM_STAMSTAR_DESCRIPTION	握住这颗星星可以立刻回复精力。
ITEM_MINCHROOM_JUICE_NAME	蘑菇汁
ITEM_MINCHROOM_JUICE_DESCRIPTION	好喝的蘑菇血（汁）。
ITEM_LESSER_DEFENSE_POTION_NAME	小型物防药水
ITEM_LESSER_DEFENSE_POTION_DESCRIPTION	暂时地将防御提高5点。
ITEM_LESSER_EVASION_POTION_NAME	小型闪避药水
ITEM_LESSER_EVASION_POTION_DESCRIPTION	暂时提高闪避率3%。
ITEM_LESSER_MGK_DEFENSE_POTION_NAME	小型魔防药水
ITEM_LESSER_MGK_DEFENSE_POTION_DESCRIPTION	暂时地将魔法防御提高5点。
ITEM_LESSER_REGENERATION_POTION_NAME	小型再生药水
ITEM_LESSER_REGENERATION_POTION_DESCRIPTION	随着时间的推移每秒回复3点生命值。
ITEM_DEFENSE_POTION_NAME	物防药水
ITEM_DEFENSE_POTION_DESCRIPTION	暂时地将防御提高10点。
ITEM_EVASION_POTION_NAME	闪避药水
ITEM_EVASION_POTION_DESCRIPTION	暂时提高闪避率5%。
ITEM_MGK_DEFENSE_POTION_NAME	魔法防御药水
ITEM_MGK_DEFENSE_POTION_DESCRIPTION	暂时地将魔法防御提高10点。
ITEM_REGENERATION_POTION_NAME	再生药水
ITEM_REGENERATION_POTION_DESCRIPTION	随着时间的推移每秒回复8点生命值。
ITEM_TOME_OF_EXPERIENCE_NAME	经验之书
ITEM_TOME_OF_EXPERIENCE_DESCRIPTION	这本书记载的知识能为阅读者提供可观的经验。
ITEM_TOME_OF_GREATER_EXPERIENCE_NAME	经验巨著
ITEM_TOME_OF_GREATER_EXPERIENCE_DESCRIPTION	这本巨著记载的知识能够为阅读者提供大量的经验。
ITEM_TOME_OF_LESSER_EXPERIENCE_NAME	经验残卷
ITEM_TOME_OF_LESSER_EXPERIENCE_DESCRIPTION	这本书记载的知识能为阅读者提供些许的经验。
ITEM_TOME_OF_NAIVETY_NAME	本我之书
ITEM_TOME_OF_NAIVETY_DESCRIPTION	阅读这本书会重置你的所有属性，并返还你的属性点。<color=lime>只能在安全区使用。</color>
ITEM_TOME_OF_UNLEARNING_NAME	遗忘之书
ITEM_TOME_OF_UNLEARNING_DESCRIPTION	阅读这本书会重置你的所有技能，并返还你的技能点。<color=lime>只能在安全区使用。</color>
ITEM_AGILITY_STONE_NAME	敏捷之石
ITEM_AGILITY_STONE_DESCRIPTION	具有将武器的伤害加成来源更改为敏捷属性的能力。
ITEM_ANGELAS_TEAR_NAME	安琪拉的泪滴
ITEM_ANGELAS_TEAR_DESCRIPTION	在持有者死亡时立即复活。
ITEM_BLIGHTWOOD_LOG_NAME	枯木妖原木
ITEM_BLIGHTWOOD_LOG_DESCRIPTION	内部非常热，燃着一簇蓝色的火焰，似乎永远不会熄灭。
ITEM_BLIGHTWOOD_STICK_NAME	枯木妖树枝
ITEM_BLIGHTWOOD_STICK_DESCRIPTION	拿在手里，依旧能感觉到暖意。
ITEM_BLUE_MINCHROOM_CAP_NAME	蓝蘑菇妖菌盖
ITEM_BLUE_MINCHROOM_CAP_DESCRIPTION	它的孢子足以将人冻伤，说不定能放房间里避避暑。
ITEM_BRONZE_ARROWS_NAME	铜箭
ITEM_BRONZE_ARROWS_DESCRIPTION	给弓使用的箭矢。
ITEM_CARBUNCLE_FOOT_NAME	绯咒者的脚
ITEM_CARBUNCLE_FOOT_DESCRIPTION	腐化为绯咒者的术士留下的断肢。它滴下的血液可化作蕴含魔力的魔尘。
ITEM_CURSED_NOTE_NAME	诅咒符纸
ITEM_CURSED_NOTE_DESCRIPTION	符纸上有一些魔法符号，它们看起来像悬浮在纸上。
ITEM_DEADWOOD_LOG_NAME	腐木妖原木
ITEM_DEADWOOD_LOG_DESCRIPTION	炽热，橙色的能量在这根原木中涌动。
ITEM_DEATHGEL_CORE_NAME	腐臭史莱姆之核
ITEM_DEATHGEL_CORE_DESCRIPTION	从腐臭史莱姆中挖出的块状物。
ITEM_DIVA_NECKLACE_NAME	女王的项链
ITEM_DIVA_NECKLACE_DESCRIPTION	太大了戴不上，不过很值钱。
ITEM_FLUX_STONE_NAME	魔源之石
ITEM_FLUX_STONE_DESCRIPTION	具有将武器的伤害加成来源更改为智力属性的能力。
ITEM_GEIST_COLLAR_NAME	幽魂的项圈
ITEM_GEIST_COLLAR_DESCRIPTION	即便晃动时，铃铛也不会发出任何声音。
ITEM_GHOSTDUST_NAME	幽灵尘
ITEM_GHOSTDUST_DESCRIPTION	一瓶余烬，来自依旧彷徨的鬼魂。
ITEM_GOLEM_CORE_NAME	魔像之核
ITEM_GOLEM_CORE_DESCRIPTION	曾为魔像之心，沉重如旧。
ITEM_GOLEM_GEM_NAME	魔像宝石
ITEM_GOLEM_GEM_DESCRIPTION	一缕红色的薄雾在这颗宝石中蜿蜒。
ITEM_GREEN_LIPSTICK_NAME	绿色口红
ITEM_GREEN_LIPSTICK_DESCRIPTION	味道像酸苹果糖。
ITEM_HELLSLUDGE_CORE_NAME	狱火史莱姆之核
ITEM_HELLSLUDGE_CORE_DESCRIPTION	从狱火史莱姆中挖出的块状物。
ITEM_ILLUSION_STONE_NAME	幻象石
ITEM_ILLUSION_STONE_DESCRIPTION	这种神奇的石头可以用来改变东西的外观。
ITEM_MAW_EYE_NAME	巨鄂怪的眼睛
ITEM_MAW_EYE_DESCRIPTION	涣散的瞳孔里透出一丝焦虑。
ITEM_MEKBOAR_HEAD_NAME	突突猪的头
ITEM_MEKBOAR_HEAD_DESCRIPTION	它的鼻子还在不停抽动。
ITEM_MEKBOAR_SPEAR_NAME	突突猪的角
ITEM_MEKBOAR_SPEAR_DESCRIPTION	没人清楚这样的枪头到底是怎么插上野猪变成角的。
ITEM_MIGHT_STONE_NAME	力量之石
ITEM_MIGHT_STONE_DESCRIPTION	具有将武器的伤害加成来源更改为力量属性的能力。
ITEM_MONOLITH_CORE_NAME	巨石魔像之核
ITEM_MONOLITH_CORE_DESCRIPTION	巨石魔像的核心。深绿色的能量在其内部涌动。
ITEM_MONOLITH_GEM_NAME	巨石魔像宝石
ITEM_MONOLITH_GEM_DESCRIPTION	巨石魔像身上的一块巨大的绿色宝石。可能是突变的产物。
ITEM_MOUTH_BITTERTOOTH_NAME	大嘴怪的毒牙
ITEM_MOUTH_BITTERTOOTH_DESCRIPTION	牙尖滴落的毒液仿佛取之不尽。
ITEM_MOUTH_EYE_NAME	大嘴怪的眼睛
ITEM_MOUTH_EYE_DESCRIPTION	很软，但戳不破。
ITEM_RAGEBOAR_HEAD_NAME	愤愤猪的头
ITEM_RAGEBOAR_HEAD_DESCRIPTION	充血的眼睛里满是愤怒。
ITEM_RAGEBOAR_SPEAR_NAME	愤愤猪的角
ITEM_RAGEBOAR_SPEAR_DESCRIPTION	角上的血迹警示着非同小可的杀伤力。
ITEM_RED_MINCHROOM_CAP_NAME	红蘑菇妖菌盖
ITEM_RED_MINCHROOM_CAP_DESCRIPTION	它的孢子足以点着大火，说不定能当辣味调味料来用。
ITEM_ROCK_NAME	石头
ITEM_ROCK_DESCRIPTION	只是块普通的石头，可以用来丢向敌人。
ITEM_SLIME_CORE_NAME	史莱姆之核
ITEM_SLIME_CORE_DESCRIPTION	从史莱姆中挖出的块状物。
ITEM_SLIME_DIVA_EARS_NAME	史莱姆女王的耳朵
ITEM_SLIME_DIVA_EARS_DESCRIPTION	又大又长。不像别的史莱姆的耳朵，它摸起来不尖锐反而很柔软。
ITEM_SLIME_EARS_NAME	史莱姆的耳朵
ITEM_SLIME_EARS_DESCRIPTION	耳朵的末端意外的尖锐，被扇到了还真会挺疼。
ITEM_SLIMEK_CORE_NAME	史莱米库之核
ITEM_SLIMEK_CORE_DESCRIPTION	从史莱米库中挖出的块状物。
ITEM_SLIMEK_EARS_NAME	史莱米库的耳朵
ITEM_SLIMEK_EARS_DESCRIPTION	比普通史莱姆的耳朵更尖一些。
ITEM_SLIMEK_EYE_NAME	史莱米库的眼睛
ITEM_SLIMEK_EYE_DESCRIPTION	盯着瞳孔正中够久的话，花纹就会开始旋转。
ITEM_SOUL_PEARL_NAME	灵魂珍珠
ITEM_SOUL_PEARL_DESCRIPTION	赋予持有者复生已逝之魂的力量\n<color=cyan>要复活某人，靠近他们时按下交互键。</color>
ITEM_WIZBOAR_HEAD_NAME	巫巫猪的头
ITEM_WIZBOAR_HEAD_DESCRIPTION	它还在微笑着。
ITEM_WIZBOAR_SCEPTER_NAME	巫巫猪的角
ITEM_WIZBOAR_SCEPTER_DESCRIPTION	蓄满了电力。直接拿来当武器还是太大了些。
CREEP_LESSER_WISP_NAME	零星鬼火
CREEP_LESSER_WISP_NAME_VARIANT_MANY	零星鬼火
CREEP_MIASMA_NAME	瘴气鬼火
CREEP_MIASMA_NAME_VARIANT_MANY	瘴气鬼火
CREEP_GREATER_WISP_NAME	成簇鬼火
CREEP_GREATER_WISP_NAME_VARIANT_MANY	成簇鬼火
CREEP_TOXIN_NAME	剧毒鬼火
CREEP_TOXIN_NAME_VARIANT_MANY	剧毒鬼火
CREEP_ALSHAR_NAME	阿尔沙
CREEP_ALSHAR_NAME_VARIANT_MANY	阿尔沙
CREEP_CARBUNCLE_NAME	绯咒者
CREEP_CARBUNCLE_NAME_VARIANT_MANY	绯咒者
CREEP_STEZZA_NAME	斯特扎
CREEP_STEZZA_NAME_VARIANT_MANY	斯特扎
CREEP_POLTERGEIST_NAME	喧闹幽魂
CREEP_POLTERGEIST_NAME_VARIANT_MANY	喧闹幽魂
CREEP_MINI_GEIST_NAME	小幽魂
CREEP_MINI_GEIST_NAME_VARIANT_MANY	小幽魂
CREEP_GEIST_NAME	幽魂
CREEP_GEIST_NAME_VARIANT_MANY	幽魂
CREEP_LORD_ZUULNERUDA_NAME	幽魂之主-祖纳鲁达
CREEP_LORD_ZUULNERUDA_NAME_VARIANT_MANY	幽魂之主-祖纳鲁达
CREEP_LORD_KALUUZ_NAME	幽魂之主-卡鲁兹
CREEP_LORD_KALUUZ_NAME_VARIANT_MANY	幽魂之主-卡鲁兹
CREEP_GOLEM_NAME	大型魔像
CREEP_GOLEM_NAME_VARIANT_MANY	大型魔像
CREEP_MONOLITH_NAME	巨石魔像
CREEP_MONOLITH_NAME_VARIANT_MANY	巨石魔像
CREEP_DEMIGOLEM_NAME	Demigolem
CREEP_DEMIGOLEM_NAME_VARIANT_MANY	Demigolems
CREEP_COLOSSUS_NAME	撼地巨像
CREEP_COLOSSUS_NAME_VARIANT_MANY	撼地巨像
CREEP_BROXXUS_NAME	Broxxus
CREEP_BROXXUS_NAME_VARIANT_MANY	Broxxuss
CREEP_MEKBOAR_NAME	突突猪
CREEP_MEKBOAR_NAME_VARIANT_MANY	突突猪
CREEP_BOOMBOAR_NAME	轰轰猪
CREEP_BOOMBOAR_NAME_VARIANT_MANY	轰轰猪
CREEP_RAGEBOAR_NAME	愤愤猪
CREEP_RAGEBOAR_NAME_VARIANT_MANY	愤愤猪
CREEP_WIZBOAR_NAME	巫巫猪
CREEP_WIZBOAR_NAME_VARIANT_MANY	巫巫猪
CREEP_BLUE_MINCHROOM_NAME	蓝蘑菇妖
CREEP_BLUE_MINCHROOM_NAME_VARIANT_MANY	蓝蘑菇妖
CREEP_RED_MINCHROOM_NAME	红蘑菇妖
CREEP_RED_MINCHROOM_NAME_VARIANT_MANY	红蘑菇妖
CREEP_YELLOW_MINCHROOM_NAME	黄蘑菇妖
CREEP_YELLOW_MINCHROOM_NAME_VARIANT_MANY	黄蘑菇妖
CREEP_MINI_GOLEM_NAME	小型魔像
CREEP_MINI_GOLEM_NAME_VARIANT_MANY	小型魔像
CREEP_MOUTH_NAME	大嘴怪
CREEP_MOUTH_NAME_VARIANT_MANY	大嘴怪
CREEP_MAW_NAME	巨鄂怪
CREEP_MAW_NAME_VARIANT_MANY	巨鄂怪
CREEP_SLIME_NAME	史莱姆
CREEP_SLIME_NAME_VARIANT_MANY	史莱姆
CREEP_HELLSLUDGE_NAME	狱火史莱姆
CREEP_HELLSLUDGE_NAME_VARIANT_MANY	狱火史莱姆
CREEP_TAR_SPAWN_NAME	焦油史莱姆
CREEP_TAR_SPAWN_NAME_VARIANT_MANY	焦油史莱姆
CREEP_SLIMEK_NAME	史莱米库
CREEP_SLIMEK_NAME_VARIANT_MANY	史莱米库
CREEP_DEATHGEL_NAME	腐臭史莱姆
CREEP_DEATHGEL_NAME_VARIANT_MANY	腐臭史莱姆
CREEP_SLIME_DIVA_NAME	史莱姆女王
CREEP_SLIME_DIVA_NAME_VARIANT_MANY	史莱姆女王
CREEP_DEADWOOD_NAME	腐木妖
CREEP_DEADWOOD_NAME_VARIANT_MANY	腐木妖
CREEP_BLIGHTWOOD_NAME	枯木妖
CREEP_BLIGHTWOOD_NAME_VARIANT_MANY	枯木妖
CREEP_NOVICE_TRAINING_DUMMY_NAME	新手训练假人
CREEP_NOVICE_TRAINING_DUMMY_NAME_VARIANT_MANY	新手训练假人
CREEP_CLASS_TRAINING_DUMMY_NAME	职业训练假人
CREEP_CLASS_TRAINING_DUMMY_NAME_VARIANT_MANY	职业训练假人
QUEST_A_WARM_WELCOME_NAME	初来乍到
QUEST_A_WARM_WELCOME_DESCRIPTION	啊……我看到你已醒来，魂魄依旧璀璨如昔。别害怕<color=cyan>这里是你的家，也是我们的家</color>\n\n在你踏上旅程之前，请先熟悉一下圣地...<color=cyan>毕竟，这里是这个破碎世界的最后避风港</color>\n\n<color=yellow>等你参观过世界传送门、兵营、商店以及通往圣地外域的大门后，再来找我</color>\n\n<i>当然，你可以慢慢来……</i>
QUEST_A_WARM_WELCOME_COMPLETE_RETURN_MESSAGE	回到圣地去见安琪拉。
QUEST_TRIGGER_WORLDPORTALTRIGGER_PREFIX	世界传送门
QUEST_TRIGGER_WORLDPORTALTRIGGER_SUFFIX	探索
QUEST_TRIGGER_SHOPDISCOVERTRIGGER_PREFIX	商店
QUEST_TRIGGER_SHOPDISCOVERTRIGGER_SUFFIX	探索
QUEST_TRIGGER_GATEWAYDISCOVERTRIGGER_PREFIX	圣地门径
QUEST_TRIGGER_GATEWAYDISCOVERTRIGGER_SUFFIX	探索
QUEST_TRIGGER_BARRACKSDISCOVERTRIGGER_PREFIX	兵营
QUEST_TRIGGER_BARRACKSDISCOVERTRIGGER_SUFFIX	探索
QUEST_COMMUNING_CATACOMBS_NAME	调查地下墓穴
QUEST_COMMUNING_CATACOMBS_DESCRIPTION	现在的情况相当危急... <color=cyan>圣地外的地下陵墓</color>曾经是我引导魔力，用以观测不死生物动向的地方。但现在那里发生的一切我完全无法得知……\n\n<color=cyan>世界碎裂那时，我的魔法也随之分崩离析。</color> 万幸的是，我能感受到那零碎的魔力依旧存在……\n\n<color=yellow>在地下陵墓的深处有一枚无主的符印。找到它，并让它与你的灵魂相连。</color> 一旦你做到了，我们便能继续探索前方的未知……但我担心最坏的情况已经发生了。
QUEST_COMMUNING_CATACOMBS_COMPLETE_RETURN_MESSAGE	回到圣地去见安琪拉。
QUEST_TRIGGER_SIGILTRIGGER_PREFIX	符印
QUEST_TRIGGER_SIGILTRIGGER_SUFFIX	同调
QUEST_NIGHT_SPIRITS_NAME	夜中幽灵
QUEST_NIGHT_SPIRITS_DESCRIPTION	<color=cyan>在夜间，</color>来自地下陵墓的鬼火会游荡在圣地外围。一些成簇鬼火可能也会在地下陵墓内部的深处出现……\n\n<color=yellow>消灭8只零星鬼火和5只成簇鬼火。</color>\n还请务必小心，因为<color=cyan>被鬼火攻击便会受到诅咒……</color>
QUEST_NIGHT_SPIRITS_COMPLETE_RETURN_MESSAGE	回到圣地去见安琪拉。
QUEST_RIDDING_SLIMES_NAME	清除史莱姆
QUEST_RIDDING_SLIMES_DESCRIPTION	圣地外的史莱姆相当麻烦……赶走它们会对我们有很大帮助。\n\n<color=cyan>史莱姆通常会在日间出现。</color> <color=yellow>收集5个史莱姆之核，5个史莱姆的耳朵，并消灭10只史莱姆。</color>请一定要平安归来...……
QUEST_RIDDING_SLIMES_COMPLETE_RETURN_MESSAGE	回到圣地去见安琪拉。
QUEST_DISCIPLE_OF_MAGIC_NAME	魔法学徒
QUEST_DISCIPLE_OF_MAGIC_DESCRIPTION	啊！你来了，小家伙。我注意到你的能力比以前有了明显的提升…  <color=cyan>也许，你会对秘术师的生涯感兴趣吧？</color>\n\n如若你愿追随我的智慧，<color=yellow>我将赠予你一本秘籍，它会把我的力量与你紧密绑定…</color>当然，要慎重，<color=yellow>因为这可是个无法反悔的决定。</color>\n\n嗯…..哦，啊对了！<color=yellow>若你遗失了书卷，来找我，我将会再给你一本。</color>
QUEST_DISCIPLE_OF_MAGIC_COMPLETE_RETURN_MESSAGE	回到圣地去见安琪拉。
QUEST_TRIGGER_GETMYSTICCLASS_PREFIX	秘术师秘籍
QUEST_TRIGGER_GETMYSTICCLASS_SUFFIX	阅读
QUEST_MASTERY_OF_BELLS_NAME	铃铛之精通
QUEST_MASTERY_OF_BELLS_DESCRIPTION	小家伙，你以前用过魔法铃铛吗？它们相当神秘……嗯...它们<i>曾经</i>是神秘的。幸运的是，<color=cyan>我已经揭开了如何发挥它们最大力量的秘密！</color>\n\n\n<color=yellow>收下这个卷轴。它将教会你如何蓄力并释放出超乎常理的强大魔法……</color>\n\n<color=yellow>啊，对……无论如何，如果你改变了主意，回来找我，我可以提供给你任意数量的卷轴……不过要记住，掉了的话，卷轴就会消失。</color>
QUEST_MASTERY_OF_BELLS_COMPLETE_RETURN_MESSAGE	回到圣地去见安琪拉。
QUEST_TRIGGER_USEBELLSCROLL_PREFIX	铃铛精通卷轴
QUEST_TRIGGER_USEBELLSCROLL_SUFFIX	阅读
QUEST_MASTERY_OF_SCEPTERS_NAME	法杖之精通
QUEST_MASTERY_OF_SCEPTERS_DESCRIPTION	经过多年的潜心研究，<color=cyan>我发现了运用魔法权杖的奥秘！</color>小家伙，你对这些成果感兴趣吗？<color=yellow>若是如此，我可以为你提供这个技能卷轴。</color> \n\n\n<color=cyan>使用后，你就会洞悉如何凝练你的意识来掌控此类武器……</color>\n\n<color=yellow>以及，如果你改变主意了，随时可以回来找我，我会提供给你任意数量的卷轴……不过要记住，卷轴一旦掉了就会自己消失。</color>\n
QUEST_MASTERY_OF_SCEPTERS_COMPLETE_RETURN_MESSAGE	回到圣地去见安琪拉。
QUEST_TRIGGER_USESCEPTERSCROLL_PREFIX	法杖精通卷轴
QUEST_TRIGGER_USESCEPTERSCROLL_SUFFIX	阅读
QUEST_THE_KEEP_WITHIN_NAME	林中堡垒
QUEST_THE_KEEP_WITHIN_DESCRIPTION	世界正在愈合，孩子……我们必须继续前进，探索更远的地方。<color=cyan>如果我没记错的话，埃福德露台上有处通往一所古老堡垒的传送阵。在堡垒东翼和西翼的房间里，有一对符印需要你以你的灵魂去与之同调。</color>请做好准备，以面对那里所栖息的一切……
QUEST_THE_KEEP_WITHIN_COMPLETE_RETURN_MESSAGE	回到圣地去见安琪拉。
QUEST_TRIGGER_SIGILTRIGGER_00_PREFIX	西翼符印
QUEST_TRIGGER_SIGILTRIGGER_00_SUFFIX	同调
QUEST_TRIGGER_SIGILTRIGGER_01_PREFIX	东翼符印
QUEST_TRIGGER_SIGILTRIGGER_01_SUFFIX	同调
QUEST_ANCIENT_BEINGS_NAME	古老的存在
QUEST_ANCIENT_BEINGS_DESCRIPTION	这是个问题，小家伙。<color=cyan>新月堡垒周围有成群的魔像在游荡，</color>而且它们对我们敌意十足…\n\n这些魔像曾经是象征和平的存在，专门用来抵御怪物，但现在它们却反而站在了它们那边。<color=cyan>我只能推测，可能是世界的破碎导致了这一切，而它们头部的宝石使它们陷入了暴走…</color>无论如何，我都必须查明这个现象。\n\n<color=yellow>击败大小型魔像各15只，并收集15颗它们的宝珠。</color>完成任务后，我会给予你奖励…
QUEST_ANCIENT_BEINGS_COMPLETE_RETURN_MESSAGE	回到圣地去见安琪拉。
QUEST_CONSUMED_MADNESS_NAME	疯狂尽头
QUEST_CONSUMED_MADNESS_DESCRIPTION	圣所陵墓已然今非昔比，小家伙……事实上，<color=cyan>横行于地下墓穴中诅咒的真正形貌如今丑态毕露，而事态的紧急我们有目共睹。</color>我知道你承担了很多，但，<i>我相信</i>你可以做到的！\n\n防止这个地下墓穴继续腐化的唯一方法，<color=yellow>就是通过击倒不死大军中最邪恶的精锐来抚平它们的狂乱……</color>\n\n完成这项任务后，请回来找我……<color=cyan>此外，我强烈建议你在这次旅程中随身携带治疗物品！</color>
QUEST_CONSUMED_MADNESS_COMPLETE_RETURN_MESSAGE	回到圣地去见安琪拉。
QUEST_TRIGGER_SWEEPFINISHHARD_PREFIX	圣所陵墓
QUEST_TRIGGER_SWEEPFINISHHARD_SUFFIX	扫荡（lv12-18）
QUEST_SPIRALING_IN_THE_GROVE_NAME	周旋林间
QUEST_SPIRALING_IN_THE_GROVE_DESCRIPTION	<color=cyan>新月林地充斥着腐化……</color> 此番景象令人痛心，我们必须阻止事态继续恶化。\n\n<color=cyan>我相信，小家伙，你完全有能力净化这片堕落的林地。</color>\n\n<color=yellow>从新月林地的起点到终点，消灭所有栖身其间的怪物。</color>正如你所看到的，它们隐匿于朦胧的黑暗魔法中，只有当你靠近它们时才会出现。\n\n<color=cyan>一旦你助林地摆脱邪恶的支配，就回到我身边，我会为你提供一份奖励……</color>\n
QUEST_SPIRALING_IN_THE_GROVE_COMPLETE_RETURN_MESSAGE	回到圣地去见安琪拉。
QUEST_TRIGGER_SWEEPFINISHGROVENORMAL_PREFIX	新月林地
QUEST_TRIGGER_SWEEPFINISHGROVENORMAL_SUFFIX	扫荡（lv15-20）
QUEST_TETHERING_GROVE_NAME	联接林地
QUEST_TETHERING_GROVE_DESCRIPTION	自古以来，新月堡垒一直受我们世世代代所敬仰……\n\n<color=cyan>可当世界破碎时，深不见底的腐化导致了新月堡垒的覆灭。</color> 曾经居住在那里的，来自其他世界的灵魂没能过上好不容易得来的新生，而与我同族的德鲁伊们也被腐化成了祸害。\n\n<color=yellow>你可以在新月堡垒东翼的深处找到新月林地。一旦你靠近它，门就会自动打开。在新月林地中找到那枚无主的符印，并将它与你的灵魂同调。</color>潜伏在林地里的怪物们强大无比！请一定做好准备，小家伙。\n
QUEST_TETHERING_GROVE_COMPLETE_RETURN_MESSAGE	回到圣地去见安琪拉。
QUEST_TRIGGER_GROVESIGILTRIGGER_PREFIX	新月林地符印
QUEST_TRIGGER_GROVESIGILTRIGGER_SUFFIX	同调
QUEST_THE_EFFOLD_TERRACE_NAME	埃福德露台的种种
QUEST_THE_EFFOLD_TERRACE_DESCRIPTION	你说在地下墓穴遇到了史莱姆的埋伏？好吧……我应该能简单捋清我们现在的状况。\n\n既然你用你勇敢的灵魂修复了一部分符印与结界，通往埃福德露台的传送阵现在应该能对你开放了。\n\n<color=cyan>那个传送阵位于地下墓穴地表入口的东北面。</color>根据我能观测到露台的状况来看，那里到处都是肮脏的史莱米库。与普通史莱姆不同，它们更强大，而且富含焦油。\n\n<color=yellow>消灭15个史莱米库，保证安全，然后回来找我……</color>
QUEST_THE_EFFOLD_TERRACE_COMPLETE_RETURN_MESSAGE	回到圣地去见安琪拉。
QUEST_CLEANING_TERRACE_NAME	清理露台
QUEST_CLEANING_TERRACE_DESCRIPTION	哼，那些讨厌的史莱米库又在捣乱了！<color=cyan>埃福德露台</color>可不能再这么脏乱下去了需要即刻清理来改善环境……\n\n或许你可以帮我这个忙，顺便给他们展现一下你的能力？<color=yellow>消灭20只史莱米库，</color>然后…有空就来回找我……
QUEST_CLEANING_TERRACE_COMPLETE_RETURN_MESSAGE	回到圣地去见安琪拉。
QUEST_DIVA_MUST_DIE_NAME	女王必须死
QUEST_DIVA_MUST_DIE_DESCRIPTION	看来你对女王的史莱米库族群造成了很大的伤害。现在是时候趁热打铁，使出你的全力去点破她虚张的攻势了。\n\n从露台周围的龙脉流动来看，<color=cyan>如果史莱姆女王的子嗣不断被消灭的话，她最终就会现身……</color>\n\n也许史莱米库最多的角落，便是她最有可能藏匿的地方。我相信你能给她一个教训，对吧？
QUEST_DIVA_MUST_DIE_COMPLETE_RETURN_MESSAGE	回到圣地去见安琪拉。
QUEST_RATTLECAGE_RAGE_NAME	笼中狂怒
QUEST_RATTLECAGE_RAGE_DESCRIPTION	嗯…哦！我知道闯荡地下墓穴对你来说可能有些艰难，对吗？啊，啊呀…？没有的事…？那…这样，你知道吗？每次你进入地下墓穴，它的内部似乎都会扭曲，变幻。<color=cyan>通往它的入口已经腐化，会不断改变里面的构造。</color>\n\n<i>我知道你能胜任这项任务，小家伙……</i>\n\n<color=yellow>从圣所陵墓的入口一直到最深处，请你清除墓穴内所有的邪恶气息。</color>一旦你<color=yellow>正常地…</color>完成了这个挑战，就回来找我吧。当然，请注意安全。
QUEST_RATTLECAGE_RAGE_COMPLETE_RETURN_MESSAGE	回到圣地去见安琪拉。
QUEST_TRIGGER_SWEEPFINISH_PREFIX	圣所陵墓
QUEST_TRIGGER_SWEEPFINISH_SUFFIX	扫荡（lv6-12）
QUEST_HUNTIN_HOGS_NAME	狩猎野猪
QUEST_HUNTIN_HOGS_DESCRIPTION	你的灵魂依旧强韧，小家伙。要不我来派你去做些更……嗯，<i>刺激</i>的事？\n\n<color=cyan>在圣地外围侧面有一条小道，</color>到处都是被称为突突猪的恶劣生物。他们头上顶着危险的武器，会攻击任何进入他们领地的人……\n\n如果可以的话，请展示你的技艺并<color=yellow>消灭20只突突猪，再收集15根愤愤猪的角。</color>\n\n当你事成之后回来找我……
QUEST_HUNTIN_HOGS_COMPLETE_RETURN_MESSAGE	回到圣地去见安琪拉。
QUEST_MASTERY_OF_BLADES_NAME	剑之精通
QUEST_MASTERY_OF_BLADES_DESCRIPTION	看来现在你已经能熟练运用你的力量了，流离者。<color=yellow>拿上这个卷轴吧。</color><color=cyan>阅读它可以加强你使用单手近战武器的能力。</color>只要集中注意力，你就能用蓄力攻击和跳劈对你的敌人展开压倒性的攻势。\n\n<color=yellow>你要是反悔了，可以随时回来找我。卷轴我这要多少有多少。不过要记住，你丢弃卷轴时它会直接消失。</color>
QUEST_MASTERY_OF_BLADES_COMPLETE_RETURN_MESSAGE	回到圣地去见伊诺克。
QUEST_TRIGGER_USEMELEESCROLL_PREFIX	轻武器精通卷轴
QUEST_TRIGGER_USEMELEESCROLL_SUFFIX	阅读
QUEST_MASTERY_OF_HAMMERS_NAME	重锤之精通
QUEST_MASTERY_OF_HAMMERS_DESCRIPTION	<color=cyan>使用重型武器需要十分强大的力量，流离者。</color>而我认为，你很有这方面的潜力。<color=yellow>要是觉得你能承受得了这种战斗方式，就拿上这个卷轴。</color><color=cyan>读完它，你就会对如何把敌人砸成尸块了如指掌。</color>\n\n<color=yellow>你要是反悔了，可以随时回来找我。卷轴我这要多少有多少。不过要记住，你丢弃卷轴时它会直接消失。</color>
QUEST_MASTERY_OF_HAMMERS_COMPLETE_RETURN_MESSAGE	回到圣地去见伊诺克。
QUEST_TRIGGER_USEHEAVYMELEESCROLL_PREFIX	重武器精通卷轴
QUEST_TRIGGER_USEHEAVYMELEESCROLL_SUFFIX	阅读
QUEST_MASTERY_OF_SPEARS_NAME	长矛之精通
QUEST_MASTERY_OF_SPEARS_DESCRIPTION	长柄武器总能让我回想起我还在受训的日子。和别的近战武器一样，<color=cyan>它们也是沙场上的可靠伙伴。</color>我能看见你眼中的激情，流离者。<color=yellow>拿上这个卷轴吧，它能教导你学会使用长柄武器的高阶技巧。</color>\n\n<color=yellow>你要是反悔了，可以随时回来找我。卷轴我这要多少有多少。不过要记住，你丢弃卷轴时它会直接消失。</color>
QUEST_MASTERY_OF_SPEARS_COMPLETE_RETURN_MESSAGE	回到圣地去见伊诺克。
QUEST_TRIGGER_USEPOLEARMSCROLL_PREFIX	长兵精通卷轴
QUEST_TRIGGER_USEPOLEARMSCROLL_SUFFIX	阅读
QUEST_STRENGTH_AND_HONOR_NAME	力量与荣光
QUEST_STRENGTH_AND_HONOR_DESCRIPTION	是做出抉择的时候了，流离者。你所展现的力量与技巧早已证明<color=cyan>你有着配得上战士之名的本色。</color>\n\n若你成为一名战士，你将有能力对抗遍布这世界的邪恶怪物，令它们闻风丧胆。<color=yellow>拿上这本秘籍。</color>阅读后，我将与你同在，你我齐心斩断黑暗。\n\n<color=yellow>如果你碰巧丢失秘籍，回我这里。卷轴我这要多少有多少。</color><color=cyan>记住，读完之后，你就没有回头路了。</color>
QUEST_STRENGTH_AND_HONOR_COMPLETE_RETURN_MESSAGE	回到圣地去见伊诺克。
QUEST_TRIGGER_GETFIGHTERCLASS_PREFIX	战士秘籍
QUEST_TRIGGER_GETFIGHTERCLASS_SUFFIX	阅读
QUEST_ERADICATING_THE_UNDEAD_NAME	剿灭不死生物
QUEST_ERADICATING_THE_UNDEAD_DESCRIPTION	是时候了，流离者。<color=cyan>圣所陵墓终于露出了它的真面目，而对不死生物发起反攻的时刻也已到来。</color>尽管愚蠢又盲目，这个咒语下的不死军团依旧无情而强大。\n\n我们必须制止这些怪物，以免它们进一步腐化我们的世界。<color=yellow>消灭25只瘴气鬼火，15只狱火史莱姆，和30只喧闹幽魂。你可以在圣所陵墓最险恶的层面中找到它们。</color>让我们的怒火焚尽这些不死生物，杀他们个片甲不留。\n
QUEST_ERADICATING_THE_UNDEAD_COMPLETE_RETURN_MESSAGE	回到圣地去见伊诺克。
QUEST_PURGING_THE_GROVE_NAME	净化林地
QUEST_PURGING_THE_GROVE_DESCRIPTION	<color=cyan>现在的新月林地是这世界的一处祸根。</color> 流离者，我们对林地里成群结队的怪物们已经忍无可忍。肃清他们，让它们从腐化的狂乱中得到解脱。\n\n<color=yellow>摧毁30只腐木妖、25只绯咒者、10只蓝蘑菇妖和15只巨石魔像。</color> 任务完成后，立刻回来见我。\n
QUEST_PURGING_THE_GROVE_COMPLETE_RETURN_MESSAGE	回到圣地去见伊诺克。
QUEST_REVILING_THE_RAGEBOARS_NAME	痛击愤愤猪
QUEST_REVILING_THE_RAGEBOARS_DESCRIPTION	图尔山谷的愤愤猪都是一群懦夫。它们自认为有能力与我们抗衡，真是可笑。\n\n<color=cyan>山谷深处有一座寺庙，里面全是那些该死的东西。</color>这些邪恶的野猪是由一个在这世上没有任何牵挂的邪恶生物所创造的。等到时机成熟，我们会讨论如何对付她的，流离者。担现在，我们必须先集中精力于你能够处理的事情。\n\n<color=yellow>消灭20只愤愤猪。它们就藏身于我所说的图尔山谷的寺庙里。</color>注意，你若是不慎深入寺庙，很可能会丧命。\n
QUEST_REVILING_THE_RAGEBOARS_COMPLETE_RETURN_MESSAGE	回到圣地去见伊诺克。
QUEST_THE_COLOSSUS_NAME	撼地巨像
QUEST_THE_COLOSSUS_DESCRIPTION	我看到你已经能很好地应对新月堡垒的敌人了。干得不错，流离者。<color=cyan>现在是时候向前迈出一步，前去新月林地了。</color>在那里，你将见识到一股污秽的黑暗魔力，许多曾属于我们一族的堕落之人也早已沉沦于腐化的深渊。\n\n有一对兄弟，我曾与他们熟识。他们现在成为了绯咒者，与其他被腐化的族人无异...<color=cyan>这对兄弟创造了一座魔像，一座足以将世界撕裂的巨像。</color>我们必须了结他们的阴谋。<color=yellow>摧毁那座巨像，然后来找我。</color>\n\n<color=yellow>如果你还不认路，去找安琪拉。她会指引你前往新月林地。</color>\n
QUEST_THE_COLOSSUS_COMPLETE_RETURN_MESSAGE	回到圣地去见伊诺克。
QUEST_PURGING_THE_UNDEAD_NAME	肃清不死生物
QUEST_PURGING_THE_UNDEAD_DESCRIPTION	<color=cyan>圣所陵墓就像一处无尽的炼狱，其用途就是逼迫圣地向他们臣服。</color>可惜，它们愚蠢到根本不明白自己在和谁作对。我对这些可悲的生物已经没多少耐心了。\n\n<color=cyan>你的灵魂已承载了我力量的一部分，而现在我们会让这些不死生物在痛苦中尖叫。</color><color=yellow>消灭25只剧毒鬼火，15只腐臭史莱姆，和30只幽魂。你可以在圣所陵墓中找到它们。</color>让这些不死生物好好记住，谁才是掌控这片土地的真正主人。\n
QUEST_PURGING_THE_UNDEAD_COMPLETE_RETURN_MESSAGE	回到圣地去见伊诺克。
QUEST_THE_VOICE_OF_ZUULNERUDA_NAME	祖纳鲁达之声
QUEST_THE_VOICE_OF_ZUULNERUDA_DESCRIPTION	安静。<i>听见了吗？</i> 那从墓穴深处传来的隐隐讥笑声。<color=cyan>在那深处，他，正源源不断的使死者们复生。</color>\n\n<color=cyan>他叫祖纳鲁达，</color> 是一只幽魂之主。作为不死大军中地位较高的一员骨干，他必须被清除。<color=yellow>找到祖纳鲁达，杀了他。他盘踞于那被扭曲的陵墓中层。</color>\n\n快点，流离者…时间紧迫。<color=yellow>等你手上浸满他的鲜血，再来找我。</color>\n\n<color=cyan>[在（LV6-12）圣所陵墓击败幽魂之主-祖纳鲁达]</color>
QUEST_THE_VOICE_OF_ZUULNERUDA_COMPLETE_RETURN_MESSAGE	回到圣地去见伊诺克。
QUEST_GHOSTLY_GOODS_NAME	与鬼魂讨价还价
QUEST_GHOSTLY_GOODS_DESCRIPTION	哎呀，你不介意的话，我还真有点事儿需要你帮忙！<color=cyan>如果你愿意，我还会告诉你一个小秘密，不过可得替我保密哦！</color>\n\n我正在找一种特别的幽灵材料，<color=cyan>它能研磨成细腻的小粉末，可以让用了的人隐身！</color>\n\n所以，<color=yellow>帮我去弄点幽灵尘，那些不死生物身上应该能找到；还有一些幽魂项圈，就是幽魂戴的那种怪东西。</color>\n\n弄够了再回来找我，好吗？
QUEST_GHOSTLY_GOODS_COMPLETE_RETURN_MESSAGE	回到圣地去见莎莉。
QUEST_SUMMORE_SPECTRAL_POWDER_NAME	制作更多隐身粉末！
QUEST_SUMMORE_SPECTRAL_POWDER_DESCRIPTION	嗯哼！咋样，亲爱的？那粉末是不是挺妙的，<i>对吧？</i>\n\n要是你还想要更多的话，那就再去弄点幽灵尘和幽魂项圈吧！这次不需要像之前那样多了。<color=cyan>记住啦，还是圣所陵墓那个地方找！</color>\n\n<color=yellow>带个20份幽灵尘和8个幽魂项圈回来，</color>我就再给你整一批！<i>这次我给你多做点！</i>
QUEST_SUMMORE_SPECTRAL_POWDER_COMPLETE_RETURN_MESSAGE	回到圣地去见莎莉。
QUEST_DEVIOUS_PACT_NAME	狡猾的印记
QUEST_DEVIOUS_PACT_DESCRIPTION	哎哟瞧瞧你！看来你最近可没闲着嘛！<color=cyan>>我正打算告诉你个秘密，不过这事儿只能咱俩和极少数人知道，明白吧？</color>\n\n我猜你肯定喜欢那些亮闪闪的东西？金币啊，战利品啥的？还是说喜欢让敌人晕头转向找不着你？这方面我可帮得上你……<color=cyan>信不信由你，我可是盗贼守护者！</color> 我们都为生意拼尽全力，<i>即使得用些特别的小手段达成目的....</i>\n\n<color=yellow>拿着这个，好好考虑一下要不要加入我和我的团队！记住，一旦选了可就不能反悔哦。如果不小心弄丢了，记得再来找我要！</color>
QUEST_DEVIOUS_PACT_COMPLETE_RETURN_MESSAGE	回到圣地去见莎莉。
QUEST_TRIGGER_GETBANDITCLASS_PREFIX	盗贼秘籍
QUEST_TRIGGER_GETBANDITCLASS_SUFFIX	阅读
QUEST_MAKIN_A_VILE_BLADE_NAME	制作一把极恶之剑
QUEST_MAKIN_A_VILE_BLADE_DESCRIPTION	<color=cyan>对了，你去过新月堡垒了没？</color> 我听说那地方现在被那些有口臭的家伙占据了！呃...我们还没确定该怎么称呼它们，<color=cyan>所以呢!就简单地叫它们“大嘴怪”吧。</color>\n\n我知道我们该做点什么了，让它们尝尝自己的“味道”！？<color=yellow>把一粗陋之剑、5颗大嘴怪牙、3颗史莱米库的眼睛和10块腐臭史莱姆之核带来给我！</color> 我们就能把那把刀做得像它们一样恶心！亲爱的。\n\n<color=cyan>你可以在新月堡垒找到粗陋之剑，在埃福德露台找到史莱米库，在圣所陵墓找到腐臭史莱姆！</color>\n\n
QUEST_MAKIN_A_VILE_BLADE_COMPLETE_RETURN_MESSAGE	回到圣地去见莎莉。
QUEST_MAKIN_A_WIZWAND_NAME	制作一把巫巫法杖
QUEST_MAKIN_A_WIZWAND_DESCRIPTION	<color=cyan>亲爱的，你见过那些奇怪的巫巫猪了吗？</color> 那帮家伙总是看起来一副很开心的样子，但相信我，它们可不是什么好东西！\n\n或许我们可以做个小一点、更好用的法杖，就像它们用的那种，对吧？<color=yellow>帮我弄来一根巫巫猪的角、5根枯木妖树枝和5块枯木妖原木！</color> 怎么样？\n
QUEST_MAKIN_A_WIZWAND_COMPLETE_RETURN_MESSAGE	回到圣地去见莎莉。
QUEST_MAKIN_MORE_VILE_BLADES_NAME	制作更多极恶之剑
QUEST_MAKIN_MORE_VILE_BLADES_DESCRIPTION	<color=cyan>准备好再造一把极恶之剑了吗？</color> 好的！\n\n<color=yellow>拿给我一把粗陋之剑、5颗大嘴怪牙、3颗史莱米库的眼睛，还有10个腐臭史莱姆之核！</color>\n\n\n<color=cyan>你可以在新月堡垒找到粗陋之剑，在埃福德露台找到史莱米库，腐臭史莱姆就在圣所陵墓等着你！</color>\n
QUEST_MAKIN_MORE_VILE_BLADES_COMPLETE_RETURN_MESSAGE	回到圣地去见莎莉。
QUEST_MAKIN_MORE_WIZWANDS_NAME	制作更多巫巫法杖
QUEST_MAKIN_MORE_WIZWANDS_DESCRIPTION	<color=cyan>想再做一根巫巫法杖吗？</color> 咱可以搞定！不过提前跟你说一声，<i>还是需要一样的材料。</i>\n\n<color=yellow>拿来1根巫巫猪的角、5根枯木妖树枝和5块枯木妖原木！</color>剩下的我们会搞定的！\n\n
QUEST_MAKIN_MORE_WIZWANDS_COMPLETE_RETURN_MESSAGE	回到圣地去见莎莉。
QUEST_MASTERY_OF_KATARS_NAME	拳剑之精通
QUEST_MASTERY_OF_KATARS_DESCRIPTION	哎呀！你瞧瞧？我本还以为自己再也不会跟别人说这些事儿了，不过既然你问了，那我就告诉你吧。\n\n很久以前，我可天天都在琢磨怎么在商界中占据一席之地，确保每一笔交易都顺利进行，也没有绊脚石。<color=cyan>那些日子里，我摸索出了一套适用拳刃的特殊技巧！</color> 这些小家伙既锋利又迅速，瞬间就能把我的竞争对手干趴下！\n\n要是你对我说的这些技能感兴趣，我可以教你！<color=yellow>拿着这卷轴，它能给你所需的力量，把那些小喽啰揍得服服帖帖！</color>\n\n<color=yellow>当然啦，如果你改主意了，随时可以来找我，我再给你一份卷轴。要是不小心丢了，记得再来找我要哦！</color>
QUEST_MASTERY_OF_KATARS_COMPLETE_RETURN_MESSAGE	回到圣地去见莎莉。
QUEST_TRIGGER_USEKATARSCROLL_PREFIX	拳剑精通卷轴
QUEST_TRIGGER_USEKATARSCROLL_SUFFIX	阅读
QUEST_MASTERY_OF_RANGE_NAME	远程之精通
QUEST_MASTERY_OF_RANGE_DESCRIPTION	<color=cyan>你有没有想过自己可能会对远程武器的使用技巧感兴趣呢？</color> 听着可能有点意外，亲爱的。但说真的我可是对这些东西很有一套的哦！这些技巧曾经可是救过我和我的队伍无数次命呢！\n\n嗯…如果你也想学点这方面的本事，我可以教你！<color=yellow> 拿着这张卷轴吧，它会教你如何掌握远程武器的使用技巧，让它们的威力发挥到极致！ </color>\n\n<color=yellow>当然啦，随时可以来找我，我随时可以再给你一张。不过记得，这卷轴可不能随便丢，一旦掉地它就会消失，明白了吗？</color>
QUEST_MASTERY_OF_RANGE_COMPLETE_RETURN_MESSAGE	回到圣地去见莎莉。
QUEST_TRIGGER_USERANGEDSCROLL_PREFIX	远程精通卷轴
QUEST_TRIGGER_USERANGEDSCROLL_SUFFIX	阅读
QUEST_MAKIN_A_GOLEM_CHESTPIECE_NAME	制作一套魔像胸甲
QUEST_MAKIN_A_GOLEM_CHESTPIECE_DESCRIPTION	<color=cyan>那些新月堡垒的魔像可真是强得吓人！</color>不过，咱们能利用它们的魔核和宝石拿来做点有意思的东西，做个结实的胸甲绝对没问题！\n\n\n<color=yellow>把10个魔像之核和15个魔像宝珠带来，</color>咱们就能打造出这件强力的胸甲了！
QUEST_MAKIN_A_GOLEM_CHESTPIECE_COMPLETE_RETURN_MESSAGE	回到圣地去见莎莉。
QUEST_SUMMORE_GOLEM_CHESTPIECES_NAME	制作更多魔像胸甲
QUEST_SUMMORE_GOLEM_CHESTPIECES_DESCRIPTION	哦？<color=cyan>你想再做一个魔像胸甲吗？</color>那你得给我一样的材料，亲爱的！\n\n<color=yellow>带来10个魔像之核和15个魔像宝珠，</color>我们就能做出那副胸甲！\n
QUEST_SUMMORE_GOLEM_CHESTPIECES_COMPLETE_RETURN_MESSAGE	回到圣地去见莎莉。
QUEST_MAKIN_A_RAGESPEAR_NAME	制作一把愤愤长枪
QUEST_MAKIN_A_RAGESPEAR_DESCRIPTION	嗯，我记得！你之前做过一把突突长枪，对吧？<color=cyan>想让它更强力一点吗？咱们可以试试……</color>\n\n<color=yellow>去图尔山谷找那些愤愤猪，我需要它们头上的角！</color>  它们比你之前遇到的那些突突猪要难对付些，所以要集中精神，亲爱的！\n\n<color=yellow>另外，我还需要15个狱火史莱姆之核来把它们拼起来。这些东西得从圣所陵墓里最难搞的狱火史莱姆身上弄到….哦对了，记得带上你的突突长枪！</color>
QUEST_MAKIN_A_RAGESPEAR_COMPLETE_RETURN_MESSAGE	回到圣地去见莎莉。
QUEST_MAKIN_MORE_RAGESPEARS_NAME	制作更多愤愤长枪
QUEST_MAKIN_MORE_RAGESPEARS_DESCRIPTION	<color=cyan>嗯？又想弄把愤愤长枪，是吧，亲爱的？</color> 好嘞！咱们需要这些东西：\n\n<color=yellow>一把突突长枪，一把愤愤猪长枪，还有15个狱火史莱姆之核！</color>\n\n<color=cyan>把这些搞定，咱就能把它打造得更强！愤愤猪可以在图尔山谷找到，可得去圣所陵墓最难的地方找找！ </color> 祝你好运啦！
QUEST_MAKIN_MORE_RAGESPEARS_COMPLETE_RETURN_MESSAGE	回到圣地去见莎莉。
QUEST_MAKIN_A_MONOLITH_CHESTPIECE_NAME	制作一件巨像胸甲
QUEST_MAKIN_A_MONOLITH_CHESTPIECE_DESCRIPTION	<color=cyan>还记得我们之前做的那个魔像胸甲吗？</color>告诉你，我有办法让它<i>更强大！</i>\n\n<color=cyan>在新月林地里，住着一种更强大的魔像！</color>它们可是很麻烦的家伙！\n\n让我们用它们的材料做一件更强的胸甲吧！<color=yellow>带上……一个魔像胸甲，15个巨石魔像之核，10个巨石魔像宝石，还有5张来自新月林地的诅咒符纸！</color>\n\n<i>怎么样？</i>\n
QUEST_MAKIN_A_MONOLITH_CHESTPIECE_COMPLETE_RETURN_MESSAGE	回到圣地去见莎莉。
QUEST_SUMMORE_MONOLITH_CHESTPIECES_NAME	制作更多巨石魔像胸甲
QUEST_SUMMORE_MONOLITH_CHESTPIECES_DESCRIPTION	哈！又想做一件巨石魔像胸甲吗？好嘞！我们需要这些材料：\n\n<color=yellow>嗯...带上……一件魔像胸甲，15个巨石魔像之核，10个巨石魔像宝珠，还有5张来自新月林地的诅咒符纸！</color>\n\n<i>如何？</i>\n
QUEST_SUMMORE_MONOLITH_CHESTPIECES_COMPLETE_RETURN_MESSAGE	回到圣地去见莎莉。
QUEST_MAKIN_A_MEKSPEAR_NAME	制作一把突突长枪
QUEST_MAKIN_A_MEKSPEAR_DESCRIPTION	嗨，亲爱的！<color=cyan>我刚刚在想着能搞点啥有趣的东西，怎么也得试试做个厉害的长矛吧？</color> 你看，那些突突猪脑袋上的矛看起来挺尖的，对吧？\n\n这样吧，拿给我……嗯，<color=yellow>一根从突突猪脑袋脑袋上弄下来角，再加15个史莱米库的核，用来把它固定好。</color>到时候我会给你做一把漂亮的阔头枪！咋样，听起来不错吧？\n
QUEST_MAKIN_A_MEKSPEAR_COMPLETE_RETURN_MESSAGE	回到圣地去见莎莉。
QUEST_MAKIN_MORE_MEKSPEARS_NAME	制作更多突突长枪
QUEST_MAKIN_MORE_MEKSPEARS_DESCRIPTION	<color=cyan>又想要来弄把突突长枪啊？</color> 好嘞，没问题！\n\n你知道规矩的！我需要……<color=yellow>一根从突突猪脑袋脑袋上弄下来角，还要15个史莱米库的核，这样我才能帮你做出来。</color>完事后我会给你做一把漂亮的阔头枪！咋样，听起来不错吧？\n
QUEST_MAKIN_MORE_MEKSPEARS_COMPLETE_RETURN_MESSAGE	回到圣地去见莎莉。
CONDITION_BURN_NAME	烧伤
CONDITION_BURN_1_DESCRIPTION	燃烧中。
CONDITION_COLD_NAME	冰冻
CONDITION_COLD_1_DESCRIPTION	冰冻中。
CONDITION_GASH_NAME	流血
CONDITION_GASH_1_DESCRIPTION	每0.4秒造成3点流血伤害。
CONDITION_POISON_NAME	中毒
CONDITION_POISON_1_DESCRIPTION	中毒中。
CONDITION_VILEBLADE_POISON_NAME	极恶之毒
CONDITION_VILEBLADE_POISON_1_DESCRIPTION	中毒中。
CONDITION_WEAKENING_NAME	虚弱
CONDITION_WEAKENING_0_DESCRIPTION	物理防御力降低5。
CONDITION_CYRO_SLOW_NAME	迟缓
CONDITION_CYRO_SLOW_0_DESCRIPTION	冰冻，移动速度变得缓慢。
CONDITION_DEFENSE_POTION_NAME	物防药水
CONDITION_DEFENSE_POTION_0_DESCRIPTION	物理防御力提升5。
CONDITION_DEFENSE_POTION_1_DESCRIPTION	物理防御力提升10。
CONDITION_EVASION_POTION_NAME	闪避药水
CONDITION_EVASION_POTION_0_DESCRIPTION	闪避率提升3%。
CONDITION_EVASION_POTION_1_DESCRIPTION	闪避率提升5%。
CONDITION_EVASION_POTION_2_DESCRIPTION	闪避率提升7%。
CONDITION_MGK_DEFENSE_POTION_NAME	魔防药水
CONDITION_MGK_DEFENSE_POTION_0_DESCRIPTION	魔法防御力提升5。
CONDITION_MGK_DEFENSE_POTION_1_DESCRIPTION	魔法防御力提升10。
CONDITION_REGENERATION_POTION_NAME	再生药水
CONDITION_REGENERATION_POTION_0_DESCRIPTION	再生3点生命值。
CONDITION_REGENERATION_POTION_1_DESCRIPTION	再生8点生命值。
CONDITION_SPECTRAL_POWDER_NAME	隐身粉末
CONDITION_SPECTRAL_POWDER_0_DESCRIPTION	获得隐身，任何攻击或者受击都会导致此效果失效。
CONDITION_WISP_CURSE_NAME	鬼火诅咒
CONDITION_WISP_CURSE_1_DESCRIPTION	所有攻击属性值降低2。
CONDITION_WISP_CURSE_2_DESCRIPTION	所有攻击属性值降低5。
CONDITION_WISP_CURSE_3_DESCRIPTION	所有攻击属性值降低10。
CONDITION_WISP_CURSE_4_DESCRIPTION	吸取5点生命值。
CONDITION_EXECUTE_NAME	处决
CONDITION_EXECUTE_1_DESCRIPTION	
CONDITION_BOUNCE_NAME	弹跳
CONDITION_BOUNCE_1_DESCRIPTION	闪避率提升100%。
CONDITION_DEVIOUS_SIGNET_NAME	狡猾印记
CONDITION_DEVIOUS_SIGNET_1_DESCRIPTION	闪避率和暴击率提升5%，耐力上限提升5。
CONDITION_DEVIOUS_SIGNET_2_DESCRIPTION	闪避率和暴击率提升5%，耐力上限提升10。
CONDITION_DEVIOUS_SIGNET_3_DESCRIPTION	闪避率和暴击率提升10%，耐力上限提升10。
CONDITION_DEVIOUS_SIGNET_4_DESCRIPTION	闪避率和暴击率提升10%，耐力上限提升15。
CONDITION_DEVIOUS_SIGNET_5_DESCRIPTION	闪避率和暴击率提升15%，耐力上限提升15。
CONDITION_DEVIOUS_SIGNET_6_DESCRIPTION	闪避率和暴击率提升15%，耐力上限提升20。
CONDITION_KILLER_JAB_NAME	暗杀突刺
CONDITION_KILLER_JAB_1_DESCRIPTION	物理防御力降低10，移动速度降低20%。
CONDITION_MIST_VEIL_NAME	迷雾傍身
CONDITION_MIST_VEIL_1_DESCRIPTION	获得隐身，每1.2秒回复5点生命值。攻击会移除此效果。
CONDITION_MIST_VEIL_2_DESCRIPTION	获得隐身，每1.2秒回复5点生命值。攻击会移除此效果。
CONDITION_MIST_VEIL_3_DESCRIPTION	获得隐身，每1.2秒回复5点生命值。攻击会移除此效果。
CONDITION_MIST_VEIL_4_DESCRIPTION	获得隐身，每1.2秒回复5点生命值。攻击会移除此效果。
CONDITION_PAY_DAY_NAME	收获日
CONDITION_PAY_DAY_1_DESCRIPTION	被盗贼击晕并洗劫一空。
CONDITION_PAY_DAY_2_DESCRIPTION	被盗贼击晕并洗劫一空。
CONDITION_PAY_DAY_3_DESCRIPTION	被盗贼击晕并洗劫一空。
CONDITION_PAY_DAY_4_DESCRIPTION	被盗贼击晕并洗劫一空。
CONDITION_VENOM_SHOT_NAME	淬毒射击
CONDITION_VENOM_SHOT_1_DESCRIPTION	使目标中毒，物理防御力降低3。
CONDITION_VENOM_SHOT_2_DESCRIPTION	使目标中毒，物理防御力降低6。
CONDITION_VENOM_SHOT_3_DESCRIPTION	使目标中毒，物理防御力降低9。
CONDITION_VENOM_SHOT_4_DESCRIPTION	使目标中毒，物理防御力降低12。
CONDITION_VENOM_SHOT_5_DESCRIPTION	使目标中毒，物理防御力降低15。
CONDITION_VENOM_SHOT_6_DESCRIPTION	使目标中毒，物理防御力降低18。
CONDITION_BLOOD_GUSH_NAME	血汩之刃
CONDITION_BLOOD_GUSH_1_DESCRIPTION	流血
CONDITION_BLOOD_GUSH_2_DESCRIPTION	流血
CONDITION_BLOOD_GUSH_3_DESCRIPTION	流血
CONDITION_BLOOD_GUSH_4_DESCRIPTION	流血
CONDITION_LETHAL_STRIKE_NAME	致命突袭
CONDITION_LETHAL_STRIKE_1_DESCRIPTION	闪避率提升100%。
CONDITION_RAGE_NAME	怒火
CONDITION_RAGE_1_DESCRIPTION	所有攻击属性值提升<color=yellow>5</color>。
CONDITION_RAGE_2_DESCRIPTION	所有攻击属性值提升<color=yellow>8</color>。
CONDITION_RAGE_3_DESCRIPTION	所有攻击属性值提升<color=yellow>15</color>。
CONDITION_RAGE_4_DESCRIPTION	所有攻击属性值提升<color=yellow>20</color>。
CONDITION_RAGE_5_DESCRIPTION	所有攻击属性值提升<color=yellow>25</color>。
CONDITION_RAGE_6_DESCRIPTION	所有攻击属性值提升<color=yellow>32</color>。
CONDITION_SHIELD_BASH_NAME	盾牌猛击
CONDITION_SHIELD_BASH_1_DESCRIPTION	眩晕中。
CONDITION_SHIELD_BASH_2_DESCRIPTION	眩晕中。
CONDITION_SHIELD_BASH_3_DESCRIPTION	眩晕中。
CONDITION_SHIELD_BASH_4_DESCRIPTION	眩晕中。
CONDITION_STOMP_NAME	重踏
CONDITION_STOMP_1_DESCRIPTION	减速25%，物理防御力降低15。
CONDITION_BLINK_NAME	闪现术
CONDITION_BLINK_1_DESCRIPTION	闪现
CONDITION_CROSS_FLASH_NAME	圣光
CONDITION_CROSS_FLASH_1_DESCRIPTION	魔法防御力降低5。
CONDITION_CROSS_FLASH_2_DESCRIPTION	魔法防御力降低10。
CONDITION_CROSS_FLASH_3_DESCRIPTION	魔法防御力降低15。
CONDITION_CROSS_FLASH_4_DESCRIPTION	魔法防御力降低20。
CONDITION_FLUXSPEAR_NAME	魔源矛
CONDITION_FLUXSPEAR_1_DESCRIPTION	眩晕中。
CONDITION_FLUXSPEAR_2_DESCRIPTION	眩晕中。
CONDITION_FLUXSPEAR_3_DESCRIPTION	眩晕中。
CONDITION_FLUXSPEAR_4_DESCRIPTION	眩晕中。
CONDITION_IMBUE_NAME	灌魔术
CONDITION_IMBUE_1_DESCRIPTION	魔攻值提升5，魔法防御力提升5，魔力上限提升10。
CONDITION_IMBUE_2_DESCRIPTION	魔攻值提升10，魔法防御力提升5，魔力上限提升10。
CONDITION_IMBUE_3_DESCRIPTION	魔攻值提升15，魔法防御力提升10，魔力上限提升20。
CONDITION_IMBUE_4_DESCRIPTION	魔攻值提升20，魔法防御力提升10，魔力上限提升20。
CONDITION_IMBUE_5_DESCRIPTION	魔攻值提升25，魔法防御力提升15，魔力上限提升25。
CONDITION_PRISM_NAME	棱镜术
CONDITION_PRISM_1_DESCRIPTION	最多吸收10伤害。
CONDITION_PRISM_2_DESCRIPTION	最多吸收20伤害。
CONDITION_PRISM_3_DESCRIPTION	最多吸收30伤害。
CONDITION_PRISM_4_DESCRIPTION	最多吸收40伤害。
CONDITION_PRISM_5_DESCRIPTION	最多吸收50伤害。
CONDITION_RESTORA_NAME	恢复术
CONDITION_RESTORA_1_DESCRIPTION	通过恢复术治疗。
CONDITION_ALACRITY_NAME	轻捷
CONDITION_ALACRITY_1_DESCRIPTION	下一个技能立刻施法，并且不消耗魔力值，生命值或耐力值。
CONDITION_INNER_FOCUS_NAME	聚精会神
CONDITION_INNER_FOCUS_1_DESCRIPTION	下一次物理或魔法攻击将会有100%的暴击率。
CONDITION_LEG_UP_NAME	飞毛腿
CONDITION_LEG_UP_1_DESCRIPTION	移动速度提升<color=yellow>20%</color>，闪避率提升<color=yellow>12%</color>。
CONDITION_LEG_UP_2_DESCRIPTION	移动速度提升<color=yellow>30%</color>，闪避率提升<color=yellow>14%</color>。
CONDITION_LEG_UP_3_DESCRIPTION	移动速度提升<color=yellow>40%</color>，闪避率提升<color=yellow>16%</color>。
CONDITION_RECALL_NAME	召回
CONDITION_RECALL_0_DESCRIPTION	
CONDITION_RECOVERY_NAME	恢复
CONDITION_RECOVERY_1_DESCRIPTION	每2秒回复<color=yellow>3</color>点生命值。
CONDITION_RECOVERY_2_DESCRIPTION	每2秒回复<color=yellow>6</color>点生命值。
CONDITION_RECOVERY_3_DESCRIPTION	每2秒回复<color=yellow>9</color>点生命值。
CONDITION_RECOVERY_4_DESCRIPTION	每2秒回复<color=yellow>12</color>点生命值。
CONDITION_RECOVERY_5_DESCRIPTION	每2秒回复上限<color=yellow>24%</color>的生命值。
CONDITION_SIPHON_LEECH_NAME	虹吸血蛭
CONDITION_SIPHON_LEECH_1_DESCRIPTION	每秒造成3点吸血伤害。
CONDITION_SIPHON_LEECH_2_DESCRIPTION	每秒造成4点吸血伤害。
CONDITION_SIPHON_LEECH_3_DESCRIPTION	每秒造成5点吸血伤害。
CONDITION_STURDY_NAME	结实
CONDITION_STURDY_1_DESCRIPTION	免疫击退，自动招架来袭的攻击。
CONDITION_STURDY_2_DESCRIPTION	免疫击退，自动招架来袭的攻击。
CONDITION_STURDY_3_DESCRIPTION	免疫击退，自动招架来袭的攻击。
STAT_MODIFIER_DIVINE_TAG	神圣的
STAT_MODIFIER_EARTHEN_TAG	大地的
STAT_MODIFIER_ELDRITCH_TAG	异界的
STAT_MODIFIER_ENERGETIC_TAG	不倦的
STAT_MODIFIER_GUARDIAN_TAG	守卫的
STAT_MODIFIER_KILLER_TAG	杀手的
STAT_MODIFIER_LIVELY_TAG	生机的
STAT_MODIFIER_MAGICAL_TAG	魔法的
STAT_MODIFIER_MANAFONT_TAG	注能的
STAT_MODIFIER_MOLTEN_TAG	熔融的
STAT_MODIFIER_PRECISE_TAG	精准的
STAT_MODIFIER_TIDAL_TAG	潮汐的
RACE_IMP_NAME	小鬼
RACE_IMP_DESCRIPTION	来自一处遍布重型机械的深海领域，如今被遗弃了的小恶魔。曾有一时，他们连自行思考都做不到，只能听从召唤他们的奥术师使唤。
RACE_IMP_MISC	犄角
RACE_POON_NAME	珀尔
RACE_POON_DESCRIPTION	一支古老但依旧繁荣的树精种族。依靠自身的机智与狡猾，珀尔们在养育他们的深林中已不再只是猎物，能够对抗任何侵犯他们的外敌。
RACE_POON_MISC	角枝
RACE_KUBOLD_NAME	钴博
RACE_KUBOLD_DESCRIPTION	形似爬行动物、天生擅长使用魔法的隐居族群。钴博们的故乡位于一片偏远干燥的沙漠，且四面皆被奥术与魔法所遮蔽并保护。
RACE_KUBOLD_MISC	犄角
RACE_BYRDLE_NAME	毕鸟
RACE_BYRDLE_DESCRIPTION	优雅而灵敏的旅人，普遍带有些许功利心。待成年后，年轻的毕鸟便会立下誓言，离开养育他们的族群与王国，踏上寻求属于自己宿命的漫漫征途。
RACE_BYRDLE_MISC	喙
RACE_CHANG_NAME	常鼠
RACE_CHANG_DESCRIPTION	个头矮小却坚韧无比，总是追求着超越自身界限的宏大冒险。常鼠们来自一个神秘而先进的文明，但他们常常被视为异类，时常还会被当做惹事精。
RACE_CHANG_MISC	胡须
COMBAT_ELEMENT_AIR_NAME	风
COMBAT_ELEMENT_EARTH_NAME	土
COMBAT_ELEMENT_FIRE_NAME	火
COMBAT_ELEMENT_HOLY_NAME	神圣
COMBAT_ELEMENT_NORMAL_NAME	普通
COMBAT_ELEMENT_SHADOW_NAME	暗影
COMBAT_ELEMENT_WATER_NAME	水
PLAYER_CLASS_EMPTY_NAME	新手
PLAYER_CLASS_FIGHTER_NAME	战士
PLAYER_CLASS_MYSTIC_NAME	秘术师
PLAYER_CLASS_BANDIT_NAME	盗贼
SKILL_BELL_MASTERY_NAME	铃铛精通
SKILL_BELL_MASTERY_DESCRIPTION	学会进一步使用魔法铃铛的能力，允许施法者用它来进行充能攻击。
SKILL_H_MELEE_MASTERY_NAME	重武器精通
SKILL_H_MELEE_MASTERY_DESCRIPTION	学会更熟练使用重武器的能力。
SKILL_KATAR_MASTERY_NAME	拳剑精通
SKILL_KATAR_MASTERY_DESCRIPTION	学会更熟练使用拳剑的能力。
SKILL_MELEE_MASTERY_NAME	轻武器精通
SKILL_MELEE_MASTERY_DESCRIPTION	学会更熟练使用轻武器的能力。
SKILL_POLEARM_MASTERY_NAME	长兵精通
SKILL_POLEARM_MASTERY_DESCRIPTION	学会更熟练使用长柄武器的能力。
SKILL_RANGED_MASTERY_NAME	远程精通
SKILL_RANGED_MASTERY_DESCRIPTION	学会更熟练使用远程武器的能力。
SKILL_SCEPTER_MASTERY_NAME	法杖精通
SKILL_SCEPTER_MASTERY_DESCRIPTION	学会进一步使用法杖的能力，充能时释放出更强大的子弹。
SKILL_CRYO_NEEDLE_NAME	寒冰尖刺
SKILL_CRYO_NEEDLE_DESCRIPTION	快速施放一组旋转的冰针。
SKILL_DIVINE_NAME	圣域
SKILL_DIVINE_DESCRIPTION	在施法者下方放置一口圣井，随着时间的推移伤害目标并且治疗盟友。
SKILL_EXECUTE_NAME	处决
SKILL_EXECUTE_DESCRIPTION	对目标造成伤害，如果目标生命值较低则有概率立即处决。<color=lime>需要持有物理近战武器。</color>
SKILL_FIREBALL_NAME	火球术
SKILL_FIREBALL_DESCRIPTION	每升一级都会施放一个额外的火球。
SKILL_GEYSER_NAME	喷泉术
SKILL_GEYSER_DESCRIPTION	施放一滴魔法水滴，落到地上后会爆炸形成一根冰柱。
SKILL_LIFE_TAP_NAME	生命转换
SKILL_LIFE_TAP_DESCRIPTION	通过消耗施法者的生命值来完全补充施法者的魔力值。<color=cyan>如果施法者没有足够的生命值或魔力值已满则无效。</color>
SKILL_SPIRE_NAME	尖刺术
SKILL_SPIRE_DESCRIPTION	在地面上塑造一列尖锐的地刺。
SKILL_SPREAD_SHOT_NAME	分裂射击
SKILL_SPREAD_SHOT_DESCRIPTION	发射一系列散开的子弹。<color=lime>需要持有远程武器。</color>
SKILL_FLAK_NAME	高射炮
SKILL_FLAK_DESCRIPTION	施放一阵飞沙走石。
SKILL_TALUS_NAME	Talus
SKILL_TALUS_DESCRIPTION	生成一块巨石，砸向地面。
SKILL_AGILE_TECHNIQUE_NAME	敏捷技巧
SKILL_AGILE_TECHNIQUE_DESCRIPTION	盗贼的动作变得更加杂技化，解锁了全新的移动方式。
SKILL_BOUNCE_NAME	弹跳
SKILL_BOUNCE_DESCRIPTION	弓步下跳，触地后高高向上弹起。
SKILL_BOMB_TRAP_NAME	炸弹陷阱
SKILL_BOMB_TRAP_DESCRIPTION	放置一个陷阱，当附近有目标时自动爆炸。
SKILL_DEVIOUS_SIGNET_NAME	狡猾印记
SKILL_DEVIOUS_SIGNET_DESCRIPTION	对盗贼和附近盟友施加印记，提升闪避率、耐力上限和暴击率。
SKILL_KILLER_JAB_NAME	暗杀突刺
SKILL_KILLER_JAB_DESCRIPTION	重击目标，造成大量伤害和中毒减益<color=lime>需要持有物理近战武器。</color>
SKILL_MIST_VEIL_NAME	迷雾傍身
SKILL_MIST_VEIL_DESCRIPTION	盗贼从其身体中释放出一团雾气，使其隐身并且短暂地回复。
SKILL_PAY_DAY_NAME	收获日
SKILL_PAY_DAY_DESCRIPTION	盗贼击晕目标，同时造成它们掉落金币。\n<color=lime>需要持有物理近战武器。</color>
SKILL_VENOM_SHOT_NAME	淬毒射击
SKILL_VENOM_SHOT_DESCRIPTION	发射一枚涂满毒液的子弹。持续造成伤害，同时降低目标物理防御力。<color=lime>需要持有远程武器。</color>
SKILL_VOLLEY_NAME	齐射
SKILL_VOLLEY_DESCRIPTION	<color=cyan>蓄力以释放技能。</color>向空中发射一枚子弹，在下方一定半径范围内形成箭雨。<color=lime>需要持有远程武器。</color>
SKILL_BULWARK_NAME	堡垒
SKILL_BULWARK_DESCRIPTION	增加战士的防御力。
SKILL_REFLECT_NAME	反击
SKILL_REFLECT_DESCRIPTION	如果成功招架，则允许战士反击近战伤害。
SKILL_BLOOD_GUSH_NAME	血汩之刃
SKILL_BLOOD_GUSH_DESCRIPTION	造成伤害，然后对击中的目标施加持续流血伤害。<color=lime>需要持有物理近战武器。</color>
SKILL_CYCLONE_NAME	旋回刃
SKILL_CYCLONE_DESCRIPTION	战士们将武器当作回旋镖扔出，对目标持续造成高威胁的伤害。<color=lime>需要持有双手物理近战武器</color>
SKILL_LETHAL_STRIKE_NAME	致命突袭
SKILL_LETHAL_STRIKE_DESCRIPTION	<color=cyan>蓄力以释放技能。</color>使战士冲刺，并在击中目标时发动重击。<color=lime>需要持有物理近战武器</color>
SKILL_RAGE_NAME	怒火
SKILL_RAGE_DESCRIPTION	让战士和附近盟友陷入狂怒，<color=lime>短时提升所有的攻击属性值。</color>
SKILL_SHIELD_BASH_NAME	盾牌猛击
SKILL_SHIELD_BASH_DESCRIPTION	战士用盾牌进行猛击，击中后可造成短时间的眩晕。<color=lime>需要持有盾牌。</color>
SKILL_STOMP_NAME	重踏
SKILL_STOMP_DESCRIPTION	践踏地面，伤害附近的敌人。<color=lime>造成高威胁。</color>
SKILL_BLINK_NAME	闪现术
SKILL_BLINK_DESCRIPTION	解锁不同位置之间快速传送的能力。
SKILL_MANAFLOW_NAME	魔力回路
SKILL_MANAFLOW_DESCRIPTION	与施法者周围的能量进行交流，获得更快的魔力再生。
SKILL_CROSS_NAME	圣十字
SKILL_CROSS_DESCRIPTION	<color=cyan>蓄力以释放技能。</color>显现出神秘魔法的源泉，爆炸并击退敌人。
SKILL_FLUXBOLT_NAME	魔源弹
SKILL_FLUXBOLT_DESCRIPTION	施放一枚魔法子弹，击中目标时爆炸。不同等级拥有不同的命中次数。
SKILL_FLUXSPEAR_NAME	魔源矛
SKILL_FLUXSPEAR_DESCRIPTION	在施法者面前施放出一把充满奥术魔法的刺穿之矛，造成伤害的同时击晕所有相邻的目标。
SKILL_IMBUE_NAME	灌魔术
SKILL_IMBUE_DESCRIPTION	为施法者和附近盟友注入秘术之灵，<color=cyan>提升它们的魔力上限和魔攻值。</color>
SKILL_NOVA_NAME	超新星
SKILL_NOVA_DESCRIPTION	范围技能，在施法者周围迸发一圈魔法能量，击退敌人。
SKILL_PRISM_NAME	棱镜术
SKILL_PRISM_DESCRIPTION	在施法者周围形成一道护盾，吸收任何受到的伤害。
SKILL_RESTORA_NAME	恢复术
SKILL_RESTORA_DESCRIPTION	恢复施法者和附近盟友的生命值。
SKILL_ALACRITY_NAME	轻捷
SKILL_ALACRITY_DESCRIPTION	施加一次通透施法之恩惠。下一次施法将立即生效，且不会消耗魔力值、生命值或耐力值。
SKILL_INNER_FOCUS_NAME	聚精会神
SKILL_INNER_FOCUS_DESCRIPTION	提供一个增益效果，保证下次攻击拥有100%的暴击率。
SKILL_LEG_UP_NAME	飞毛腿
SKILL_LEG_UP_DESCRIPTION	获得一个移动速度提升的增益，同时提升闪避率。
SKILL_RECALL_NAME	召回
SKILL_RECALL_DESCRIPTION	将玩家召回圣地，生成一个传送门用来返回施法者原本所在地区。<color=lime>只能在圣地外施放。</color>
SKILL_RECOVERY_NAME	恢复
SKILL_RECOVERY_DESCRIPTION	获得一个治疗状态，随着时间的推移恢复生命值。
SKILL_ROCK_TOSS_NAME	岩石投掷
SKILL_ROCK_TOSS_DESCRIPTION	投掷一块岩石，对击中的目标造成高威胁。
SKILL_SIPHON_LEECH_NAME	虹吸血蛭
SKILL_SIPHON_LEECH_DESCRIPTION	发射一枚虹吸子弹，在受击目标身上生成可怕的血蛭，回复施法者与造成伤害相同的生命值。
SKILL_STURDY_NAME	结实
SKILL_STURDY_DESCRIPTION	给予自身免疫击退和自动招架攻击的增益。
STAT_ATTRIBUTE_STRENGTH_NAME	力量
STAT_ATTRIBUTE_STRENGTH_DESCRIPTOR	提升物攻值和耐力上限。
STAT_ATTRIBUTE_MIND_NAME	智力
STAT_ATTRIBUTE_MIND_DESCRIPTOR	提升魔攻值和魔力上限。
STAT_ATTRIBUTE_DEXTERITY_NAME	敏捷
STAT_ATTRIBUTE_DEXTERITY_DESCRIPTOR	提升敏攻值，物理暴击率%和魔法暴击率%。
STAT_ATTRIBUTE_VITALITY_NAME	活力
STAT_ATTRIBUTE_VITALITY_DESCRIPTOR	提升生命上限。
WEAPON_TYPE_UNARMED_NAME	徒手
WEAPON_TYPE_KATARS_NAME	拳剑
WEAPON_TYPE_MELEE_NAME	轻武器
WEAPON_TYPE_HEAVY_MELEE_NAME	重武器
WEAPON_TYPE_POLEARM_NAME	长兵
WEAPON_TYPE_RANGE_WEAPON_NAME	远程武器
WEAPON_TYPE_MAGIC_SCEPTER_NAME	法杖
WEAPON_TYPE_MAGIC_BELL_NAME	魔法铃铛
DIALOGDATA_ANGELA_NAME_TAG	安琪拉
DIALOGDATA_ANGELA_BRANCH_0_DIALOG_0_INPUT	嗯？
DIALOGDATA_ANGELA_BRANCH_0_DIALOG_0_INPUT_ALT_0	嗯？
DIALOGDATA_ANGELA_BRANCH_0_DIALOG_0_INPUT_ALT_1	行？
DIALOGDATA_ANGELA_BRANCH_0_DIALOG_0_INPUT_ALT_2	哦？
DIALOGDATA_ANGELA_BRANCH_0_DIALOG_0_SELECTION_0	没事...
DIALOGDATA_ANGELA_BRANCH_0_DIALOG_0_SELECTION_1	我想知道关于...
DIALOGDATA_ANGELA_BRANCH_0_DIALOG_0_SELECTION_2	有什么任务吗？
DIALOGDATA_ANGELA_BRANCH_1_DIALOG_0_INPUT	嗯...让我们看看你都能做些什么吧？
DIALOGDATA_ANGELA_BRANCH_1_DIALOG_0_INPUT_ALT_0	嗯...让我们看看你能做些什么吧？
DIALOGDATA_ANGELA_BRANCH_1_DIALOG_0_INPUT_ALT_1	嗯，好吧.....让我看看…...
DIALOGDATA_ANGELA_BRANCH_1_DIALOG_0_INPUT_ALT_2	这个世界，是否亟需一份纯净？
DIALOGDATA_ANGELA_BRANCH_1_DIALOG_0_SELECTION_0	再见！
DIALOGDATA_ANGELA_BRANCH_1_DIALOG_0_SELECTION_1	还有一件事…
DIALOGDATA_ANGELA_BRANCH_2_DIALOG_0_INPUT	我的知识为你所用，有什么我能帮忙的？
DIALOGDATA_ANGELA_BRANCH_2_DIALOG_0_SELECTION_0	事实上...
DIALOGDATA_ANGELA_BRANCH_2_DIALOG_0_SELECTION_1	什么是秘术师？
DIALOGDATA_ANGELA_BRANCH_2_DIALOG_0_SELECTION_2	我们在哪儿？
DIALOGDATA_ANGELA_BRANCH_2_DIALOG_0_SELECTION_3	你是谁？
DIALOGDATA_ANGELA_BRANCH_2_DIALOG_0_SELECTION_4	召唤？
DIALOGDATA_ANGELA_BRANCH_3_DIALOG_0_INPUT	我们身处圣地，这片被污染世界中最后的和平之地…
DIALOGDATA_ANGELA_BRANCH_3_DIALOG_1_INPUT	只要我在，那些邪恶生物就永远别想进入圣地。命运使然，我必须留在此地，守护圣地的安全。
DIALOGDATA_ANGELA_BRANCH_3_DIALOG_1_SELECTION_0	我明白了。总之……
DIALOGDATA_ANGELA_BRANCH_4_DIALOG_0_INPUT	你可真是个好奇的孩子啊……
DIALOGDATA_ANGELA_BRANCH_4_DIALOG_1_INPUT	我是三位守护者之一，自这片土地诞生之初便与它共存。
DIALOGDATA_ANGELA_BRANCH_4_DIALOG_2_INPUT	我曾经洞悉万物，但因为一些不幸的缘由……我的魔法如今受到了压制。
DIALOGDATA_ANGELA_BRANCH_4_DIALOG_3_INPUT	如今，我所能做的仅是维系这破碎世界的交织，守护圣地免受黑暗侵袭。
DIALOGDATA_ANGELA_BRANCH_4_DIALOG_4_INPUT	没有我的魔法庇护，你的灵魂将被囚禁，永远迷失……在任何地方。
DIALOGDATA_ANGELA_BRANCH_4_DIALOG_4_SELECTION_0	我明白了。总之……
DIALOGDATA_ANGELA_BRANCH_4_DIALOG_4_SELECTION_1	那…实在让人不安。
DIALOGDATA_ANGELA_BRANCH_5_DIALOG_0_INPUT	你现在很安全，小家伙…
DIALOGDATA_ANGELA_BRANCH_5_DIALOG_1_INPUT	请不要迷茫，这里有许多与你并肩的游魂，他们能与你一同守护这片净土
DIALOGDATA_ANGELA_BRANCH_5_DIALOG_2_INPUT	无论如何，都不要放弃……我相信你。
DIALOGDATA_ANGELA_BRANCH_6_DIALOG_0_INPUT	哦？你对我的研究感兴趣？
DIALOGDATA_ANGELA_BRANCH_6_DIALOG_1_INPUT	咳咳……
DIALOGDATA_ANGELA_BRANCH_6_DIALOG_2_INPUT	抱歉，我不常被人问到这个...
DIALOGDATA_ANGELA_BRANCH_6_DIALOG_3_INPUT	投身于秘术师，它能解开你内心潜能的枷锁，使你掌握强大咒语的力量。
DIALOGDATA_ANGELA_BRANCH_6_DIALOG_4_INPUT	它们能够为自己构筑防护屏障，射出爆炸箭矢，轻松击穿所有近距离威胁……
DIALOGDATA_ANGELA_BRANCH_6_DIALOG_5_INPUT	简单来说，秘术师施展的奥术魔法皆源于我的力量……
DIALOGDATA_ANGELA_BRANCH_6_DIALOG_6_INPUT	信息量有点大，是吧？
DIALOGDATA_ANGELA_BRANCH_7_DIALOG_0_INPUT	嗯，是的……
DIALOGDATA_ANGELA_BRANCH_7_DIALOG_1_INPUT	你并非来自这个世界，孩子。生前的你，曾生活在某个遥远的地方。
DIALOGDATA_ANGELA_BRANCH_7_DIALOG_2_INPUT	什么都可能发生，我也说不清楚…
DIALOGDATA_ANGELA_BRANCH_7_DIALOG_3_INPUT	我召唤的灵魂不止你一位，而我予你们以新生便是寄望于你们，能和我们一起守护这片净土不受黑暗所侵。
DIALOGDATA_ANGELA_BRANCH_7_DIALOG_4_INPUT	我将始终确保你的灵魂保持纯净，免受圣域外游荡之物侵害。
DIALOGDATA_ANGELA_BRANCH_7_DIALOG_4_SELECTION_0	我明白了。总之……
DIALOGDATA_ANGELA_BRANCH_7_DIALOG_4_SELECTION_1	为什么选择我？
DIALOGDATA_ANGELA_BRANCH_8_DIALOG_0_INPUT	对你来说，这也是一次重新来过的机会…不是吗？
DIALOGDATA_ANGELA_BRANCH_8_DIALOG_1_INPUT	我理解你对此感到的担忧……
DIALOGDATA_ANGELA_BRANCH_8_DIALOG_2_INPUT	然而…死后在炼狱中痛苦地轮回对任何人来说都是煎熬。与其那样，不如让你的灵魂在这个世界上停留、安息，不是吗
DIALOGDATA_ANGELA_BRANCH_8_DIALOG_3_INPUT	这一点，我很确定，孩子……
DIALOGDATA_ANGELA_BRANCH_9_DIALOG_0_INPUT	
DIALOGDATA_ANGELA_BRANCH_9_DIALOG_0_INPUT_ALT_0	保重，孩子……
DIALOGDATA_ANGELA_BRANCH_9_DIALOG_0_INPUT_ALT_1	我会一直陪在你身边。
DIALOGDATA_ANGELA_BRANCH_9_DIALOG_0_INPUT_ALT_2	保重，小家伙
DIALOGDATA_ANGELA_BRANCH_9_DIALOG_0_INPUT_ALT_3	注意安全…
DIALOGDATA_ANGELA_INTRODUCTION_BRANCH_0_DIALOG_0_INPUT	
DIALOGDATA_ANGELA_INTRODUCTION_BRANCH_0_DIALOG_0_INPUT_ALT_0	天呐！
DIALOGDATA_ANGELA_INTRODUCTION_BRANCH_0_DIALOG_0_INPUT_ALT_1	啊！
DIALOGDATA_ANGELA_INTRODUCTION_BRANCH_0_DIALOG_0_INPUT_ALT_2	哎呀！
DIALOGDATA_ANGELA_INTRODUCTION_BRANCH_0_DIALOG_1_INPUT	看到我的召唤奏效，真是如释重负……我几乎确信你的灵魂早已泯没...
DIALOGDATA_ANGELA_INTRODUCTION_BRANCH_0_DIALOG_2_INPUT	我是安琪拉·弗鲁斯，圣地的秘术守护者。
DIALOGDATA_ANGELA_INTRODUCTION_BRANCH_0_DIALOG_3_INPUT	我知道你或许还有些问题要问……
DIALOGDATA_ANGELA_INTRODUCTION_BRANCH_0_DIALOG_4_INPUT	先不急着问，咱们先把你的状况理清楚，好吗？
DIALOGDATA_ANGELA_INTRODUCTION_BRANCH_0_DIALOG_4_SELECTION_0	再见！
DIALOGDATA_ENOK_NAME_TAG	伊诺克
DIALOGDATA_ENOK_BRANCH_0_DIALOG_0_INPUT	
DIALOGDATA_ENOK_BRANCH_0_DIALOG_0_INPUT_ALT_0	有事就说，别浪费时间。
DIALOGDATA_ENOK_BRANCH_0_DIALOG_0_INPUT_ALT_1	事情多得很，快点。
DIALOGDATA_ENOK_BRANCH_0_DIALOG_0_INPUT_ALT_2	说。
DIALOGDATA_ENOK_BRANCH_0_DIALOG_0_SELECTION_0	没事。
DIALOGDATA_ENOK_BRANCH_0_DIALOG_0_SELECTION_1	我想知道…
DIALOGDATA_ENOK_BRANCH_0_DIALOG_0_SELECTION_2	有任务给我吗？
DIALOGDATA_ENOK_BRANCH_1_DIALOG_0_INPUT	
DIALOGDATA_ENOK_BRANCH_1_DIALOG_0_INPUT_ALT_0	嗯？
DIALOGDATA_ENOK_BRANCH_1_DIALOG_0_INPUT_ALT_1	我清楚了。
DIALOGDATA_ENOK_BRANCH_1_DIALOG_0_INPUT_ALT_2	有什么就问。
DIALOGDATA_ENOK_BRANCH_1_DIALOG_0_INPUT_ALT_3	说说看。
DIALOGDATA_ENOK_BRANCH_1_DIALOG_0_SELECTION_0	算了...
DIALOGDATA_ENOK_BRANCH_1_DIALOG_0_SELECTION_1	你是谁？
DIALOGDATA_ENOK_BRANCH_1_DIALOG_0_SELECTION_2	什么是战士？
DIALOGDATA_ENOK_BRANCH_1_DIALOG_0_SELECTION_3	招架？
DIALOGDATA_ENOK_BRANCH_2_DIALOG_0_INPUT	我是伊诺克，战士守护者。我即光明的利爪，必让敌人领略炼狱之苦。
DIALOGDATA_ENOK_BRANCH_2_DIALOG_1_INPUT	你看着不是这世界的人。来得太晚了，现在它已日渐在被腐化。
DIALOGDATA_ENOK_BRANCH_2_DIALOG_2_INPUT	唯有为证明自己不懈奋斗的灵魂，才配得到我的力量。
DIALOGDATA_ENOK_BRANCH_2_DIALOG_3_INPUT	我能感觉到你燃起了一丝斗志。切记，你若屈服于恐惧，那你必将失败。
DIALOGDATA_ENOK_BRANCH_2_DIALOG_3_SELECTION_0	再见。
DIALOGDATA_ENOK_BRANCH_2_DIALOG_3_SELECTION_1	还有一件事…
DIALOGDATA_ENOK_BRANCH_3_DIALOG_0_INPUT	若一位流离者能向我证明自身的实力，我便能为其锤炼出配得上战士之名的血性。
DIALOGDATA_ENOK_BRANCH_3_DIALOG_1_INPUT	战士，能够撕裂敌人的肉体，使其鲜血流尽，逐渐脆弱。
DIALOGDATA_ENOK_BRANCH_3_DIALOG_2_INPUT	战士，能重创周围所有敌人，不论是在近身时一记重踏，或是自远处一招致命偷袭。
DIALOGDATA_ENOK_BRANCH_3_DIALOG_3_INPUT	只有磨练出无上的集中力，才能掌握战技的精髓，制霸沙场。
DIALOGDATA_ENOK_BRANCH_3_DIALOG_4_INPUT	如果你有这份本事，回来找我，我定会教你。
DIALOGDATA_ENOK_BRANCH_3_DIALOG_4_SELECTION_0	再见。
DIALOGDATA_ENOK_BRANCH_3_DIALOG_4_SELECTION_1	还是说点别的吧...
DIALOGDATA_ENOK_BRANCH_4_DIALOG_0_INPUT	
DIALOGDATA_ENOK_BRANCH_4_DIALOG_0_INPUT_ALT_0	确实有些事情得处理。
DIALOGDATA_ENOK_BRANCH_4_DIALOG_0_INPUT_ALT_1	让我看看你是否能胜任这项任务。
DIALOGDATA_ENOK_BRANCH_4_DIALOG_0_INPUT_ALT_2	今天…是个好日子，适合在战场上浴血厮杀。
DIALOGDATA_ENOK_BRANCH_4_DIALOG_0_INPUT_ALT_3	是时候拿出你的干劲了。
DIALOGDATA_ENOK_BRANCH_4_DIALOG_0_SELECTION_0	再见！
DIALOGDATA_ENOK_BRANCH_4_DIALOG_0_SELECTION_1	我想再说说别的…
DIALOGDATA_ENOK_BRANCH_5_DIALOG_0_INPUT	在近身搏斗中，成功招架敌人至关重要。
DIALOGDATA_ENOK_BRANCH_5_DIALOG_1_INPUT	在敌人准备攻击前格挡，就能招架他们的攻击。
DIALOGDATA_ENOK_BRANCH_5_DIALOG_2_INPUT	成功招架敌人时，你不会消耗任何耐力值。
DIALOGDATA_ENOK_BRANCH_5_DIALOG_3_INPUT	然而，只有当你的敌人与你实力相当时，这一效果才能生效。
DIALOGDATA_ENOK_BRANCH_5_DIALOG_4_INPUT	如果与你交战的敌人实力远甚于你，
DIALOGDATA_ENOK_BRANCH_5_DIALOG_5_INPUT	你会无法招架，剧烈消耗耐力，最后就会乱了阵脚。
DIALOGDATA_ENOK_BRANCH_5_DIALOG_6_INPUT	仔细观察你的敌人。只要善用战略，他们根本无足挂齿。
DIALOGDATA_ENOK_BRANCH_5_DIALOG_6_SELECTION_0	再见！
DIALOGDATA_ENOK_BRANCH_5_DIALOG_6_SELECTION_1	我想再说点别的…
DIALOGDATA_ENOK_INTRODUCTION_BRANCH_0_DIALOG_0_INPUT	看来又有新来的了。
DIALOGDATA_ENOK_INTRODUCTION_BRANCH_0_DIALOG_1_INPUT	若你渴望历练，追寻勇气的真谛，来找我。
DIALOGDATA_ENOK_INTRODUCTION_BRANCH_0_DIALOG_2_INPUT	你现在要是有什么想说的，最好抓紧说完。
DIALOGDATA_ENOK_INTRODUCTION_BRANCH_0_DIALOG_2_SELECTION_0	没事。
DIALOGDATA_ENOK_INTRODUCTION_BRANCH_0_DIALOG_2_SELECTION_1	我想了解的是…
DIALOGDATA_ENOK_INTRODUCTION_BRANCH_0_DIALOG_2_SELECTION_2	有什么任务吗？
DIALOGDATA_SANCTUMCIVILIAN_00_NAME_TAG	
DIALOGDATA_SANCTUMCIVILIAN_00_BRANCH_0_DIALOG_0_INPUT	
DIALOGDATA_SANCTUMCIVILIAN_00_BRANCH_0_DIALOG_0_INPUT_ALT_0	你好。
DIALOGDATA_SANCTUMCIVILIAN_00_BRANCH_0_DIALOG_0_INPUT_ALT_1	我想我以前见可能过你...也可能没有。
DIALOGDATA_SANCTUMCIVILIAN_00_BRANCH_0_DIALOG_0_INPUT_ALT_2	感谢老天....圣地还是安全的。
DIALOGDATA_SANCTUMCIVILIAN_00_INTRODUCTION_BRANCH_0_DIALOG_0_INPUT	
DIALOGDATA_SANCTUMCIVILIAN_00_INTRODUCTION_BRANCH_0_DIALOG_0_INPUT_ALT_0	你好。
DIALOGDATA_SALLY_NAME_TAG	莎莉
DIALOGDATA_SALLY_BRANCH_0_DIALOG_0_INPUT	哎呀！真高兴见到你！
DIALOGDATA_SALLY_BRANCH_0_DIALOG_0_INPUT_ALT_0	哎呀，看到你真是太好了！
DIALOGDATA_SALLY_BRANCH_0_DIALOG_0_INPUT_ALT_1	哈喽！需要点什么吗?
DIALOGDATA_SALLY_BRANCH_0_DIALOG_0_INPUT_ALT_2	有什么需要我做的吗？
DIALOGDATA_SALLY_BRANCH_0_DIALOG_0_SELECTION_0	没事...
DIALOGDATA_SALLY_BRANCH_0_DIALOG_0_SELECTION_1	那是什么东西？
DIALOGDATA_SALLY_BRANCH_0_DIALOG_0_SELECTION_2	有什么任务吗？
DIALOGDATA_SALLY_BRANCH_0_DIALOG_0_SELECTION_3	我想交易！
DIALOGDATA_SALLY_BRANCH_1_DIALOG_0_INPUT	得！没问题，这次出发前要些什么？买，还是卖？
DIALOGDATA_SALLY_BRANCH_1_DIALOG_0_INPUT_ALT_0	好嘞，没问题！这次出行前缺点什么？要买，还是卖？
DIALOGDATA_SALLY_BRANCH_1_DIALOG_0_INPUT_ALT_1	嘿，我这儿有你想要的货！
DIALOGDATA_SALLY_BRANCH_1_DIALOG_0_INPUT_ALT_2	做生意哪有无聊的时候啊？每一天都有新鲜事等着呢.....
DIALOGDATA_SALLY_BRANCH_1_DIALOG_0_INPUT_ALT_3	哦？是有啥亮闪闪的东西要给我吗？
DIALOGDATA_SALLY_BRANCH_1_DIALOG_0_SELECTION_0	拜拜！
DIALOGDATA_SALLY_BRANCH_1_DIALOG_0_SELECTION_1	有什么任务吗？
DIALOGDATA_SALLY_BRANCH_2_DIALOG_0_INPUT	有啥想出手的，别忘了再来找我哦！亲爱的！
DIALOGDATA_SALLY_BRANCH_2_DIALOG_0_INPUT_ALT_0	有啥要卖的，记得再来找我哦！
DIALOGDATA_SALLY_BRANCH_2_DIALOG_0_INPUT_ALT_1	乐意效劳！
DIALOGDATA_SALLY_BRANCH_2_DIALOG_0_INPUT_ALT_2	一路顺风，亲爱的！
DIALOGDATA_SALLY_BRANCH_2_DIALOG_0_INPUT_ALT_3	咱们24小时营业，随时来找我喔！
DIALOGDATA_SALLY_BRANCH_2_DIALOG_0_INPUT_ALT_4	保重哦，照顾好自己，好吗？
DIALOGDATA_SALLY_BRANCH_3_DIALOG_0_INPUT	哦，那是我的小宠物刺刺！放心啦，它不咬人的。
DIALOGDATA_SALLY_BRANCH_3_DIALOG_1_INPUT	它其实挺亲人的！虽然有时候有些让人头疼，少了它这里可就没这么热闹了
DIALOGDATA_SALLY_BRANCH_3_DIALOG_2_INPUT	对了！要是你东西太多装不下，咱们家刺刺还能吃进肚子里帮你保管，怎样有意思吧？
DIALOGDATA_SALLY_BRANCH_4_DIALOG_0_INPUT	
DIALOGDATA_SALLY_BRANCH_4_DIALOG_0_INPUT_ALT_0	你别说，还真有！
DIALOGDATA_SALLY_BRANCH_4_DIALOG_0_INPUT_ALT_1	我想，我这儿正好有些任务可以给你！
DIALOGDATA_SALLY_BRANCH_4_DIALOG_0_INPUT_ALT_2	这些差事，确实得有人处理一下了！
DIALOGDATA_SALLY_BRANCH_4_DIALOG_0_SELECTION_0	再见
DIALOGDATA_SALLY_BRANCH_4_DIALOG_0_SELECTION_1	我们来交易吧！
DIALOGDATA_SALLY_INTRODUCTION_BRANCH_0_DIALOG_0_INPUT	
DIALOGDATA_SALLY_INTRODUCTION_BRANCH_0_DIALOG_0_INPUT_ALT_0	哟！真高兴还能在这里见到新面孔！
DIALOGDATA_SALLY_INTRODUCTION_BRANCH_0_DIALOG_0_INPUT_ALT_1	喔！新面孔我可没见过你！说说看，来这儿有啥事找我呀？
DIALOGDATA_SALLY_INTRODUCTION_BRANCH_0_DIALOG_0_INPUT_ALT_2	嘿，亲爱的，欢迎！
DIALOGDATA_SALLY_INTRODUCTION_BRANCH_0_DIALOG_0_INPUT_ALT_3	嘿呀！真高兴还能见到新面孔！
DIALOGDATA_SALLY_INTRODUCTION_BRANCH_0_DIALOG_1_INPUT	我是莎莉！欢迎来到我的小店！
DIALOGDATA_SALLY_INTRODUCTION_BRANCH_0_DIALOG_2_INPUT	我这儿啥都有卖，也收点货哦！对了，亲爱的，要是你捡到了啥亮闪闪的东西，记得立马带来给我瞧瞧！
DIALOGDATA_SALLY_INTRODUCTION_BRANCH_0_DIALOG_3_INPUT	我有不少同事在各地做生意呢！要是碰到他们，记得提一嘴你认识我。
DIALOGDATA_SALLY_INTRODUCTION_BRANCH_0_DIALOG_4_INPUT	有啥事需要的，尽管开口喔！
DIALOGDATA_SALLY_INTRODUCTION_BRANCH_0_DIALOG_4_SELECTION_0	知道了，谢谢！
DIALOGDATA_SALLY_INTRODUCTION_BRANCH_0_DIALOG_4_SELECTION_1	有什么任务吗？
DIALOGDATA_SALLY_INTRODUCTION_BRANCH_0_DIALOG_4_SELECTION_2	嗯...我看看你有什么。
DIALOGDATA_SALLY_INTRODUCTION_BRANCH_1_DIALOG_0_INPUT	没问题，亲爱的！
DIALOGDATA_CRAIG_NAME_TAG	克雷格
DIALOGDATA_CRAIG_BRANCH_0_DIALOG_0_INPUT	你好啊朋友，想来交易吗？
DIALOGDATA_CRAIG_BRANCH_0_DIALOG_0_SELECTION_0	再见。
DIALOGDATA_CRAIG_BRANCH_0_DIALOG_0_SELECTION_1	我们来交易吧！
DIALOGDATA_CRAIG_BRANCH_1_DIALOG_0_INPUT	好嘞，你都有些啥？
DIALOGDATA_CRAIG_BRANCH_1_DIALOG_0_SELECTION_0	再见！
DIALOGDATA_CRAIG_INTRODUCTION_BRANCH_0_DIALOG_0_INPUT	你好老兄...
DIALOGDATA_CRAIG_INTRODUCTION_BRANCH_0_DIALOG_1_INPUT	有兴趣做点交易吗？（说真的，最好是吃的东西，我快饿死了……）
DIALOGDATA_CRAIG_INTRODUCTION_BRANCH_0_DIALOG_1_SELECTION_0	下次吧。
DIALOGDATA_CRAIG_INTRODUCTION_BRANCH_0_DIALOG_1_SELECTION_1	好啊，来交易。
DIALOGDATA_FRANKIE_NAME_TAG	芙兰琪
DIALOGDATA_FRANKIE_BRANCH_0_DIALOG_0_INPUT	想买些啥吗？
DIALOGDATA_FRANKIE_BRANCH_0_DIALOG_0_SELECTION_0	算了吧。
DIALOGDATA_FRANKIE_BRANCH_0_DIALOG_0_SELECTION_1	这会不会有点危险啊？
DIALOGDATA_FRANKIE_BRANCH_0_DIALOG_0_SELECTION_2	行吧，我买了。
DIALOGDATA_FRANKIE_BRANCH_1_DIALOG_0_INPUT	
DIALOGDATA_FRANKIE_BRANCH_1_DIALOG_0_INPUT_ALT_0	我想卖点技能卷轴！
DIALOGDATA_FRANKIE_BRANCH_1_DIALOG_0_INPUT_ALT_1	这个突突猪的头怎么样？
DIALOGDATA_FRANKIE_BRANCH_1_DIALOG_0_INPUT_ALT_2	来买点吧？我这有罐装疗膏，魔力果……
DIALOGDATA_FRANKIE_BRANCH_1_DIALOG_0_SELECTION_0	再见啦！
DIALOGDATA_FRANKIE_BRANCH_2_DIALOG_0_INPUT	哈，真是个有趣的问题……
DIALOGDATA_FRANKIE_BRANCH_2_DIALOG_1_INPUT	放心吧，我不怕这点野猪。
DIALOGDATA_FRANKIE_BRANCH_2_DIALOG_2_INPUT	不过……前方神殿里的那些猪倒是真的有点吓人。对了，我有没有提到过，里面还有一些宝藏可以随便拿？咳咳……
DIALOGDATA_FRANKIE_BRANCH_2_DIALOG_3_INPUT	如果我能找到一种既能活着进去又能安全出来的方法，估计我现在早就飞黄腾达了。
DIALOGDATA_FRANKIE_BRANCH_2_DIALOG_4_INPUT	你要是打算进去的话，记得留个心眼。
DIALOGDATA_FRANKIE_INTRODUCTION_BRANCH_0_DIALOG_0_INPUT	你好呀，旅行者！我是芙兰琪。
DIALOGDATA_FRANKIE_INTRODUCTION_BRANCH_0_DIALOG_1_INPUT	我准备了一些有趣的商品给你，想看看吗？
DIALOGDATA_FRANKIE_INTRODUCTION_BRANCH_0_DIALOG_1_SELECTION_0	下次吧...
DIALOGDATA_FRANKIE_INTRODUCTION_BRANCH_0_DIALOG_1_SELECTION_1	这不会有点危险吗？
DIALOGDATA_FRANKIE_INTRODUCTION_BRANCH_0_DIALOG_1_SELECTION_2	好，我买了。
DIALOGDATA_SKRIT_NAME_TAG	斯克里特
DIALOGDATA_SKRIT_BRANCH_0_DIALOG_0_INPUT	
DIALOGDATA_SKRIT_BRANCH_0_DIALOG_0_INPUT_ALT_0	斯克里特商店里有些闪闪发光的宝贝……
DIALOGDATA_SKRIT_BRANCH_0_DIALOG_0_INPUT_ALT_1	斯克里特认为你今天运气不错……
DIALOGDATA_SKRIT_BRANCH_0_DIALOG_0_INPUT_ALT_2	让运气的天平倾斜……
DIALOGDATA_SKRIT_BRANCH_0_DIALOG_0_INPUT_ALT_3	嘿，准备好开赌了吗？
DIALOGDATA_SKRIT_BRANCH_0_DIALOG_0_SELECTION_0	待会吧。
DIALOGDATA_SKRIT_BRANCH_0_DIALOG_0_SELECTION_1	赌？
DIALOGDATA_SKRIT_BRANCH_0_DIALOG_0_SELECTION_2	好啊，咱们来吧。
DIALOGDATA_SKRIT_BRANCH_1_DIALOG_0_INPUT	
DIALOGDATA_SKRIT_BRANCH_1_DIALOG_0_INPUT_ALT_0	嘿嘿...斯克里特可有些好东西。
DIALOGDATA_SKRIT_BRANCH_1_DIALOG_0_INPUT_ALT_1	斯克里特喜欢你选的玩意儿！嗤嗤嗤...
DIALOGDATA_SKRIT_BRANCH_1_DIALOG_0_INPUT_ALT_2	让我们看看事情会怎么发展…
DIALOGDATA_SKRIT_BRANCH_1_DIALOG_0_INPUT_ALT_3	好东西可都在这闪闪发光呢...
DIALOGDATA_SKRIT_BRANCH_1_DIALOG_0_SELECTION_0	我不买了...
DIALOGDATA_SKRIT_BRANCH_2_DIALOG_0_INPUT	呃？可能斯克里特忘记给你说了。
DIALOGDATA_SKRIT_BRANCH_2_DIALOG_1_INPUT	你给斯克里特一点钱，作为回报你就能拿到点好东西...
DIALOGDATA_SKRIT_BRANCH_2_DIALOG_2_INPUT	斯克里特是怎么弄到这些的可跟你没关系！嘴巴紧点儿！别乱说！
DIALOGDATA_SKRIT_BRANCH_2_DIALOG_3_INPUT	你也能刷新斯克里特这的货，不要钱！不过在你付钱之前可看不到它到底是啥。
DIALOGDATA_SKRIT_BRANCH_2_DIALOG_4_INPUT	随着你变强，斯克里特给你的东西也会越来越好，记住这点
DIALOGDATA_SKRIT_BRANCH_2_DIALOG_4_SELECTION_0	好，回见。
DIALOGDATA_SKRIT_BRANCH_2_DIALOG_4_SELECTION_1	我想试试。
DIALOGDATA_SKRIT_INTRODUCTION_BRANCH_0_DIALOG_0_INPUT	
DIALOGDATA_SKRIT_INTRODUCTION_BRANCH_0_DIALOG_0_INPUT_ALT_0	嘿，瞧瞧这是谁?
DIALOGDATA_SKRIT_INTRODUCTION_BRANCH_0_DIALOG_0_INPUT_ALT_1	斯克里特好像看到了一位潜在客户？
DIALOGDATA_SKRIT_INTRODUCTION_BRANCH_0_DIALOG_0_INPUT_ALT_2	啊...对对对，斯克里特欢迎你的到来...
DIALOGDATA_SKRIT_INTRODUCTION_BRANCH_0_DIALOG_1_INPUT	觉得自己手气不错？还是有点诸事不顺？
DIALOGDATA_SKRIT_INTRODUCTION_BRANCH_0_DIALOG_2_INPUT	斯克里特乐意收下些金币，为你的旅程提供一些潜在的帮助...
DIALOGDATA_SKRIT_INTRODUCTION_BRANCH_0_DIALOG_3_INPUT	斯克里特知道自己运气不好，但金币总能打破困境。这些闪闪发光的东西能让运气的天平倾斜。
DIALOGDATA_SKRIT_INTRODUCTION_BRANCH_0_DIALOG_4_INPUT	如果你有东西可以提供，去找斯克里特，呵呵...
DIALOGDATA_SKRIT_INTRODUCTION_BRANCH_0_DIALOG_4_SELECTION_0	算了，再见。
DIALOGDATA_SKRIT_INTRODUCTION_BRANCH_0_DIALOG_4_SELECTION_1	我想试试。
DIALOGDATA_SPIKE_NAME_TAG	刺刺
DIALOGDATA_SPIKE_BRANCH_0_DIALOG_0_INPUT	
DIALOGDATA_SPIKE_BRANCH_0_DIALOG_0_INPUT_ALT_0	汪！汪！（好吃的！好吃的！）
DIALOGDATA_SPIKE_BRANCH_0_DIALOG_0_INPUT_ALT_1	隆！隆！隆！（可算来了！东西在哪？）
DIALOGDATA_SPIKE_BRANCH_0_DIALOG_0_INPUT_ALT_2	呜呜，汪！！（带什么来了吗？）
DIALOGDATA_SPIKE_BRANCH_0_DIALOG_0_SELECTION_0	没什么...
DIALOGDATA_SPIKE_BRANCH_0_DIALOG_0_SELECTION_1	打开“刺刺”
DIALOGDATA_SPIKE_BRANCH_1_DIALOG_0_INPUT	呜？（有啥东西给我吗？）
DIALOGDATA_SPIKE_BRANCH_1_DIALOG_0_SELECTION_0	再见!
DIALOGDATA_SPIKE_BRANCH_2_DIALOG_0_INPUT	咕... (不是，你就这么点东西？)
DIALOGDATA_SPIKE_INTRODUCTION_BRANCH_0_DIALOG_0_INPUT	汪！汪！（道具！道具！）
DIALOGDATA_SPIKE_INTRODUCTION_BRANCH_0_DIALOG_0_SELECTION_0	没事...
DIALOGDATA_SPIKE_INTRODUCTION_BRANCH_1_DIALOG_0_INPUT	呜... (我......你就这么点东西？)
DIALOGDATA_VANITYMIRROR_NAME_TAG	幻象之镜
DIALOGDATA_VANITYMIRROR_BRANCH_0_DIALOG_0_INPUT	
DIALOGDATA_VANITYMIRROR_BRANCH_0_DIALOG_0_INPUT_ALT_0	噢，是的。你有没有过突然想换一副新面孔的想法？
DIALOGDATA_VANITYMIRROR_BRANCH_0_DIALOG_0_INPUT_ALT_1	你看起来有所启发...
DIALOGDATA_VANITYMIRROR_BRANCH_0_DIALOG_0_INPUT_ALT_2	准备好给自己变个样了吗？
DIALOGDATA_VANITYMIRROR_BRANCH_0_DIALOG_0_SELECTION_0	再见！
DIALOGDATA_VANITYMIRROR_BRANCH_0_DIALOG_0_SELECTION_1	幻象石？
DIALOGDATA_VANITYMIRROR_BRANCH_0_DIALOG_0_SELECTION_2	装备幻化？
DIALOGDATA_VANITYMIRROR_BRANCH_0_DIALOG_0_SELECTION_3	凝视镜子。
DIALOGDATA_VANITYMIRROR_BRANCH_1_DIALOG_0_INPUT	
DIALOGDATA_VANITYMIRROR_BRANCH_1_DIALOG_0_INPUT_ALT_0	那我们可以开始了吗？
DIALOGDATA_VANITYMIRROR_BRANCH_1_DIALOG_0_INPUT_ALT_1	你的眼里有什么？
DIALOGDATA_VANITYMIRROR_BRANCH_1_DIALOG_0_INPUT_ALT_2	你想要什么样的外观？
DIALOGDATA_VANITYMIRROR_BRANCH_1_DIALOG_0_INPUT_ALT_3	让我们开始吧。
DIALOGDATA_VANITYMIRROR_BRANCH_1_DIALOG_0_SELECTION_0	再见！
DIALOGDATA_VANITYMIRROR_BRANCH_2_DIALOG_0_INPUT	幻象之石是我力量的来源，或者更准确地说，是我服务的根本。
DIALOGDATA_VANITYMIRROR_BRANCH_2_DIALOG_1_INPUT	虽然不一定是货币，但它们被视为交易物品。
DIALOGDATA_VANITYMIRROR_BRANCH_2_DIALOG_2_INPUT	幻象石可以以高价购买，或者在外界被找到。
DIALOGDATA_VANITYMIRROR_BRANCH_2_DIALOG_3_INPUT	你更改每个类别的外观时（颜色，头部装备，身体装备），都将消耗一个幻象石。
DIALOGDATA_VANITYMIRROR_BRANCH_2_DIALOG_3_SELECTION_0	我明白了。总之……
DIALOGDATA_VANITYMIRROR_BRANCH_3_DIALOG_0_INPUT	你并不需要我的帮忙就可以幻化你的装备。
DIALOGDATA_VANITYMIRROR_BRANCH_3_DIALOG_1_INPUT	你只需要一些幻象石就能自己完成这项工作。
DIALOGDATA_VANITYMIRROR_BRANCH_3_DIALOG_2_INPUT	打开你的物品菜单，点击右上角的幻化按钮来打开你的幻化装备槽。
DIALOGDATA_VANITYMIRROR_BRANCH_3_DIALOG_3_INPUT	除了武器和戒指之外的装备都能进行幻化。
DIALOGDATA_VANITYMIRROR_BRANCH_3_DIALOG_4_INPUT	你希望幻化的装备部位需要装备上什么东西才能进行幻化并覆盖它的外观。
DIALOGDATA_VANITYMIRROR_BRANCH_3_DIALOG_5_INPUT	记好了，你没法幻化比自己等级高的装备。
DIALOGDATA_VANITYMIRROR_BRANCH_3_DIALOG_6_INPUT	借助这些新知识，我猜你已经有了许多想法，对吗？
DIALOGDATA_VANITYMIRROR_INTRODUCTION_BRANCH_0_DIALOG_0_INPUT	你好呀，我猜你对我有点兴趣？
DIALOGDATA_VANITYMIRROR_INTRODUCTION_BRANCH_0_DIALOG_1_INPUT	我乃幻象之镜，安琪拉所造之物。我的声音只会在我和愿意与我交谈之人响起。
DIALOGDATA_VANITYMIRROR_INTRODUCTION_BRANCH_0_DIALOG_2_INPUT	把幻象石带给我，我可以永久改变你的外貌。不过，请记住，你不能变成其他种族。
DIALOGDATA_VANITYMIRROR_INTRODUCTION_BRANCH_0_DIALOG_2_SELECTION_0	再见！
DIALOGDATA_VANITYMIRROR_INTRODUCTION_BRANCH_0_DIALOG_2_SELECTION_1	幻象石？
DIALOGDATA_VANITYMIRROR_INTRODUCTION_BRANCH_0_DIALOG_2_SELECTION_2	装备幻化？
DIALOGDATA_VANITYMIRROR_INTRODUCTION_BRANCH_0_DIALOG_2_SELECTION_3	凝视镜子。
DIALOGDATA_VIVIAN_NAME_TAG	薇薇安
DIALOGDATA_VIVIAN_BRANCH_0_DIALOG_0_INPUT	
DIALOGDATA_VIVIAN_BRANCH_0_DIALOG_0_INPUT_ALT_0	哼，怎么了？
DIALOGDATA_VIVIAN_BRANCH_0_DIALOG_0_INPUT_ALT_1	怎么？有事吗？
DIALOGDATA_VIVIAN_BRANCH_0_DIALOG_0_INPUT_ALT_2	呃...你需要附魔吗？
DIALOGDATA_VIVIAN_BRANCH_0_DIALOG_0_INPUT_ALT_3	喂！吓我一跳，真是的。
DIALOGDATA_VIVIAN_BRANCH_0_DIALOG_0_SELECTION_0	没事...
DIALOGDATA_VIVIAN_BRANCH_0_DIALOG_0_SELECTION_1	关于一些事...
DIALOGDATA_VIVIAN_BRANCH_0_DIALOG_0_SELECTION_2	附魔我的装备！
DIALOGDATA_VIVIAN_BRANCH_1_DIALOG_0_INPUT	
DIALOGDATA_VIVIAN_BRANCH_1_DIALOG_0_INPUT_ALT_0	行吧，希望你带够了钱。
DIALOGDATA_VIVIAN_BRANCH_1_DIALOG_0_INPUT_ALT_1	我的服务可不便宜，你最好想清楚了。
DIALOGDATA_VIVIAN_BRANCH_1_DIALOG_0_INPUT_ALT_2	嗯？哦，这我能做到。
DIALOGDATA_VIVIAN_BRANCH_1_DIALOG_0_INPUT_ALT_3	你最好能给我点新东西来附魔...
DIALOGDATA_VIVIAN_BRANCH_1_DIALOG_0_INPUT_ALT_4	好的，那么开始了。
DIALOGDATA_VIVIAN_BRANCH_1_DIALOG_0_SELECTION_0	再见啦！
DIALOGDATA_VIVIAN_BRANCH_2_DIALOG_0_INPUT	
DIALOGDATA_VIVIAN_BRANCH_2_DIALOG_0_INPUT_ALT_0	嗯，怎么了？
DIALOGDATA_VIVIAN_BRANCH_2_DIALOG_0_INPUT_ALT_1	可别问什么蠢问题...
DIALOGDATA_VIVIAN_BRANCH_2_DIALOG_0_INPUT_ALT_2	是关于附魔吗？
DIALOGDATA_VIVIAN_BRANCH_2_DIALOG_0_INPUT_ALT_3	好，我听着呢。
DIALOGDATA_VIVIAN_BRANCH_2_DIALOG_0_SELECTION_0	没事...
DIALOGDATA_VIVIAN_BRANCH_2_DIALOG_0_SELECTION_1	你好可爱！
DIALOGDATA_VIVIAN_BRANCH_2_DIALOG_0_SELECTION_2	学徒？
DIALOGDATA_VIVIAN_BRANCH_2_DIALOG_0_SELECTION_3	附魔？
DIALOGDATA_VIVIAN_BRANCH_2_DIALOG_0_SELECTION_4	武器加成？
DIALOGDATA_VIVIAN_BRANCH_3_DIALOG_0_INPUT	好了，附魔是这样运作的。
DIALOGDATA_VIVIAN_BRANCH_3_DIALOG_1_INPUT	你只需给我一件装备，武器或护甲都可以。
DIALOGDATA_VIVIAN_BRANCH_3_DIALOG_2_INPUT	根据装备的不同，花费的克朗也不同。稀有的装备还需要额外的道具作为材料进行附魔。
DIALOGDATA_VIVIAN_BRANCH_3_DIALOG_3_INPUT	不过，确保你给我的装备本身不是奇异品质的，那些我附魔不了。
DIALOGDATA_VIVIAN_BRANCH_3_DIALOG_4_INPUT	附魔是一项极为精细的工艺，几乎太不可能轻易获得你想要的效果。
DIALOGDATA_VIVIAN_BRANCH_3_DIALOG_5_INPUT	因此，你每次只能获得一个随机的附魔加成。
DIALOGDATA_VIVIAN_BRANCH_3_DIALOG_6_INPUT	你最好都听懂了，我可不想再唠叨一遍。
DIALOGDATA_VIVIAN_BRANCH_3_DIALOG_6_SELECTION_0	谢谢，再见！
DIALOGDATA_VIVIAN_BRANCH_3_DIALOG_6_SELECTION_1	我想为装备附魔。
DIALOGDATA_VIVIAN_BRANCH_4_DIALOG_0_INPUT	
DIALOGDATA_VIVIAN_BRANCH_4_DIALOG_0_INPUT_ALT_0	呃...闭嘴…
DIALOGDATA_VIVIAN_BRANCH_4_DIALOG_0_INPUT_ALT_1	…不是真有问题问，就别来烦我。
DIALOGDATA_VIVIAN_BRANCH_4_DIALOG_0_INPUT_ALT_2	你认真的？等我把你踹成猪头看你还说不说得出来这种话。
DIALOGDATA_VIVIAN_BRANCH_4_DIALOG_0_INPUT_ALT_3	说得蛮好，下次别说了。
DIALOGDATA_VIVIAN_BRANCH_4_DIALOG_0_INPUT_ALT_4	那句话哪儿出来的哪儿塞回去，我可不想听。
DIALOGDATA_VIVIAN_BRANCH_5_DIALOG_0_INPUT	是唷，我是安琪拉的学徒。一个秘术师，我负责她研究的一部分。
DIALOGDATA_VIVIAN_BRANCH_5_DIALOG_1_INPUT	我下了决心把精力放在研究附魔上，而不是继续研究攻击类魔法。
DIALOGDATA_VIVIAN_BRANCH_5_DIALOG_2_INPUT	我觉得这样的研究更轻松些。而且，如果运气好收入也不低。
DIALOGDATA_VIVIAN_BRANCH_5_DIALOG_3_INPUT	我之所以能站在这里，有自己的工坊，全是多亏了安琪拉。我打自心底尊重她，而你也该如此。
DIALOGDATA_VIVIAN_BRANCH_6_DIALOG_0_INPUT	好。是这样，如果你把一件可装备的武器放在附魔槽里，你可以改变它的伤害的加成来源属性。
DIALOGDATA_VIVIAN_BRANCH_6_DIALOG_1_INPUT	取决于你的目标是什么，你会需要找到些对应的石头。
DIALOGDATA_VIVIAN_BRANCH_6_DIALOG_2_INPUT	转化为力量属性加成，需要力量之石。
DIALOGDATA_VIVIAN_BRANCH_6_DIALOG_3_INPUT	敏捷加成需要敏捷之石。
DIALOGDATA_VIVIAN_BRANCH_6_DIALOG_4_INPUT	最后，智力加成需要魔源之石。明白了吗？总之……
DIALOGDATA_VIVIAN_BRANCH_6_DIALOG_5_INPUT	如果这个武器原本就基于你想要的属性，那么它不会消耗任何石头。挺酷的，对吧？
DIALOGDATA_VIVIAN_BRANCH_6_DIALOG_6_INPUT	这些石头世界各地都有可能找到，而且也有一些商贩出售它们。
DIALOGDATA_VIVIAN_BRANCH_6_DIALOG_7_INPUT	这些石头已经够贵了的，我就不再额外为调整属性加成收费，宰你一刀了。所以嘛……不客气。
DIALOGDATA_VIVIAN_INTRODUCTION_BRANCH_0_DIALOG_0_INPUT	嗯？噢，嗨。有事吗？
DIALOGDATA_VIVIAN_INTRODUCTION_BRANCH_0_DIALOG_1_INPUT	我是薇薇安，安琪拉的学徒。
DIALOGDATA_VIVIAN_INTRODUCTION_BRANCH_0_DIALOG_2_INPUT	我的专长是给武器和盔甲附魔。
DIALOGDATA_VIVIAN_INTRODUCTION_BRANCH_0_DIALOG_3_INPUT	如果你有些闲钱，我可以帮你这个忙。好好开口就行。
DIALOGDATA_VIVIAN_INTRODUCTION_BRANCH_0_DIALOG_4_INPUT	所以……你想要什么？对我的附魔服务感兴趣吗？
DIALOGDATA_VIVIAN_INTRODUCTION_BRANCH_0_DIALOG_4_SELECTION_0	待会吧。
DIALOGDATA_VIVIAN_INTRODUCTION_BRANCH_0_DIALOG_4_SELECTION_1	当然！
DIALOGDATA_DUNGEONPORTAL_NAME_TAG	
DIALOGDATA_DUNGEONPORTAL_BRANCH_0_DIALOG_0_INPUT	你的命运指向哪里？
DIALOGDATA_DUNGEONPORTAL_BRANCH_0_DIALOG_0_SELECTION_0	取消
DIALOGDATA_DUNGEONPORTAL_INTRODUCTION_BRANCH_0_DIALOG_0_INPUT	传送门散发着邪恶的力量！它和你曾经见过的别的传送门不一样。
DIALOGDATA_DUNGEONPORTAL_INTRODUCTION_BRANCH_0_DIALOG_1_INPUT	你的命运指向哪里？
DIALOGDATA_DUNGEONPORTAL_INTRODUCTION_BRANCH_0_DIALOG_1_SELECTION_0	取消
ITEM_RARITY_COMMON	平凡的
ITEM_RARITY_RARE	罕见的
ITEM_RARITY_EXOTIC	奇异的
ITEM_RARITY_LEGENDARY	传奇的
ITEM_RARITY_COSMETIC	服装
DAMAGE_TYPE_STRENGTH	力量
DAMAGE_TYPE_DEXTERITY	敏捷
DAMAGE_TYPE_MIND	智力
DAMAGE_TYPE_PURE	Pure
DIALOGDATA_SANCTUMCIVILIAN_00_LOCAL_BRANCH_MAP_HUB_SANCTUM__CLIENTNPCS__NPC_SANCTUMCIVILIAN_RED__DIALOGTRIGGER_DIALOG_0_INPUT	
DIALOGDATA_SANCTUMCIVILIAN_00_LOCAL_BRANCH_MAP_HUB_SANCTUM__CLIENTNPCS__NPC_SANCTUMCIVILIAN_RED__DIALOGTRIGGER_DIALOG_0_INPUT_ALT_0	这是弱肉强食的世界！而大家都知道战士处于食物链的顶端。
DIALOGDATA_SANCTUMCIVILIAN_00_LOCAL_BRANCH_MAP_HUB_SANCTUM__CLIENTNPCS__NPC_SANCTUMCIVILIAN_RED__DIALOGTRIGGER_DIALOG_0_INPUT_ALT_1	你见过回旋刃的技艺吗？那可是我一生的追求，真希望能有朝一日学会！
DIALOGDATA_SANCTUMCIVILIAN_00_LOCAL_BRANCH_MAP_HUB_SANCTUM__CLIENTNPCS__NPC_SANCTUMCIVILIAN_RED__DIALOGTRIGGER_DIALOG_0_INPUT_ALT_2	伊诺克是我崇拜的守护者，他的决心和勇气令我心生共鸣。
DIALOGDATA_SANCTUMCIVILIAN_00_LOCAL_BRANCH_MAP_HUB_SANCTUM__CLIENTNPCS__NPC_SANCTUMCIVILIAN_BLU_06__DIALOGTRIGGER_DIALOG_0_INPUT	
DIALOGDATA_SANCTUMCIVILIAN_00_LOCAL_BRANCH_MAP_HUB_SANCTUM__CLIENTNPCS__NPC_SANCTUMCIVILIAN_BLU_06__DIALOGTRIGGER_DIALOG_0_INPUT_ALT_0	我希望能看到这个世界恢复曾经的平和，不过看起来短时间内还做不到。
DIALOGDATA_SANCTUMCIVILIAN_00_LOCAL_BRANCH_MAP_HUB_SANCTUM__CLIENTNPCS__NPC_SANCTUMCIVILIAN_BLU_06__DIALOGTRIGGER_DIALOG_0_INPUT_ALT_1	你觉得天空之鲸还在注视着我们吗？
DIALOGDATA_SANCTUMCIVILIAN_00_LOCAL_BRANCH_MAP_HUB_SANCTUM__CLIENTNPCS__NPC_SANCTUMCIVILIAN_BLU_06__DIALOGTRIGGER_DIALOG_0_INPUT_ALT_2	我曾在埃福德露台生活....亲眼目睹了世界的破碎。
DIALOGDATA_SANCTUMCIVILIAN_00_LOCAL_BRANCH_MAP_HUB_SANCTUM__CLIENTNPCS__NPC_SANCTUMCIVILIAN_BLU_06__DIALOGTRIGGER_DIALOG_0_INPUT_ALT_3	唉...
DIALOGDATA_SANCTUMCIVILIAN_00_LOCAL_BRANCH_MAP_HUB_SANCTUM__CLIENTNPCS__NPC_SANCTUMCIVILIAN_BLU_01__DIALOGTRIGGER_DIALOG_0_INPUT	
DIALOGDATA_SANCTUMCIVILIAN_00_LOCAL_BRANCH_MAP_HUB_SANCTUM__CLIENTNPCS__NPC_SANCTUMCIVILIAN_BLU_01__DIALOGTRIGGER_DIALOG_0_INPUT_ALT_0	你知道吗？你可以在水下呼吸，这是安琪拉赐福所致。
DIALOGDATA_SANCTUMCIVILIAN_00_LOCAL_BRANCH_MAP_HUB_SANCTUM__CLIENTNPCS__NPC_SANCTUMCIVILIAN_BLU_01__DIALOGTRIGGER_DIALOG_0_INPUT_ALT_1	这水如此纯净，能拥有它真是我们的幸运。
DIALOGDATA_SANCTUMCIVILIAN_00_LOCAL_BRANCH_MAP_HUB_SANCTUM__CLIENTNPCS__NPC_SANCTUMCIVILIAN_BLU_01__DIALOGTRIGGER_DIALOG_0_INPUT_ALT_2	这里是圣地之湖，当日子不顺时我们就喜欢来这放松一下。
DIALOGDATA_SANCTUMCIVILIAN_00_LOCAL_BRANCH_MAP_HUB_SANCTUM__CLIENTNPCS__NPC_SANCTUMCIVILIAN_BLU_01__DIALOGTRIGGER_DIALOG_0_INPUT_ALT_3	呼嗯...我想知道外面的水咒是怎样的
DIALOGDATA_SANCTUMCIVILIAN_00_LOCAL_BRANCH_MAP_HUB_SANCTUM__CLIENTNPCS__NPC_SANCTUMCIVILIAN_BLU_02__DIALOGTRIGGER_DIALOG_0_INPUT	
DIALOGDATA_SANCTUMCIVILIAN_00_LOCAL_BRANCH_MAP_HUB_SANCTUM__CLIENTNPCS__NPC_SANCTUMCIVILIAN_BLU_02__DIALOGTRIGGER_DIALOG_0_INPUT_ALT_0	安琪拉的作品是如此神圣伟大！
DIALOGDATA_SANCTUMCIVILIAN_00_LOCAL_BRANCH_MAP_HUB_SANCTUM__CLIENTNPCS__NPC_SANCTUMCIVILIAN_BLU_02__DIALOGTRIGGER_DIALOG_0_INPUT_ALT_1	哎....我一直在努力练习“魔源弹”但目前只能命中几次……
DIALOGDATA_SANCTUMCIVILIAN_00_LOCAL_BRANCH_MAP_HUB_SANCTUM__CLIENTNPCS__NPC_SANCTUMCIVILIAN_BLU_02__DIALOGTRIGGER_DIALOG_0_INPUT_ALT_2	每次听见奥术魔法的声响都会令我感到愉悦。
DIALOGDATA_SANCTUMCIVILIAN_00_LOCAL_BRANCH_MAP_HUB_SANCTUM__CLIENTNPCS__NPC_SANCTUMCIVILIAN_BLU_02__DIALOGTRIGGER_DIALOG_0_INPUT_ALT_3	灌魔术是一个非常强力的魔法，他可以把你的近战武器附魔！
DIALOGDATA_SANCTUMCIVILIAN_00_LOCAL_BRANCH_MAP_HUB_SANCTUM__CLIENTNPCS__NPC_SANCTUMCIVILIAN_BLU_03__DIALOGTRIGGER_DIALOG_0_INPUT	
DIALOGDATA_SANCTUMCIVILIAN_00_LOCAL_BRANCH_MAP_HUB_SANCTUM__CLIENTNPCS__NPC_SANCTUMCIVILIAN_BLU_03__DIALOGTRIGGER_DIALOG_0_INPUT_ALT_0	抱歉，我现在很忙。
DIALOGDATA_SANCTUMCIVILIAN_00_LOCAL_BRANCH_MAP_HUB_SANCTUM__CLIENTNPCS__NPC_SANCTUMCIVILIAN_BLU_03__DIALOGTRIGGER_DIALOG_0_INPUT_ALT_1	没空聊，我正忙着研究。
DIALOGDATA_SANCTUMCIVILIAN_00_LOCAL_BRANCH_MAP_HUB_SANCTUM__CLIENTNPCS__NPC_SANCTUMCIVILIAN_BLU_03__DIALOGTRIGGER_DIALOG_0_INPUT_ALT_2	…
DIALOGDATA_SANCTUMCIVILIAN_00_LOCAL_BRANCH_MAP_HUB_SANCTUM__CLIENTNPCS__NPC_SANCTUMCIVILIAN_BLU_03__DIALOGTRIGGER_DIALOG_0_INPUT_ALT_3	唔…哦？抱歉，现在不方便聊。
DIALOGDATA_SANCTUMCIVILIAN_00_LOCAL_BRANCH_MAP_HUB_SANCTUM__CLIENTNPCS__NPC_SANCTUMCIVILIAN_BLU_04__DIALOGTRIGGER_DIALOG_0_INPUT	
DIALOGDATA_SANCTUMCIVILIAN_00_LOCAL_BRANCH_MAP_HUB_SANCTUM__CLIENTNPCS__NPC_SANCTUMCIVILIAN_BLU_04__DIALOGTRIGGER_DIALOG_0_INPUT_ALT_0	欢迎。我见你带着和平，走入这纷扰的尘世。
DIALOGDATA_SANCTUMCIVILIAN_00_LOCAL_BRANCH_MAP_HUB_SANCTUM__CLIENTNPCS__NPC_SANCTUMCIVILIAN_BLU_04__DIALOGTRIGGER_DIALOG_0_INPUT_ALT_1	我的同事觉得你很可爱。
DIALOGDATA_SANCTUMCIVILIAN_00_LOCAL_BRANCH_MAP_HUB_SANCTUM__CLIENTNPCS__NPC_SANCTUMCIVILIAN_BLU_04__DIALOGTRIGGER_DIALOG_0_INPUT_ALT_2	学习的时间实在太少了....
DIALOGDATA_SANCTUMCIVILIAN_00_LOCAL_BRANCH_MAP_HUB_SANCTUM__CLIENTNPCS__NPC_SANCTUMCIVILIAN_BLU_05__DIALOGTRIGGER_DIALOG_0_INPUT	
DIALOGDATA_SANCTUMCIVILIAN_00_LOCAL_BRANCH_MAP_HUB_SANCTUM__CLIENTNPCS__NPC_SANCTUMCIVILIAN_BLU_05__DIALOGTRIGGER_DIALOG_0_INPUT_ALT_0	你好，流离者。这个地方吸引了你吗？
DIALOGDATA_SANCTUMCIVILIAN_00_LOCAL_BRANCH_MAP_HUB_SANCTUM__CLIENTNPCS__NPC_SANCTUMCIVILIAN_BLU_05__DIALOGTRIGGER_DIALOG_0_INPUT_ALT_1	这座塔，为我带来孤独。
DIALOGDATA_SANCTUMCIVILIAN_00_LOCAL_BRANCH_MAP_HUB_SANCTUM__CLIENTNPCS__NPC_SANCTUMCIVILIAN_BLU_05__DIALOGTRIGGER_DIALOG_0_INPUT_ALT_2	我的同事似乎喜欢你。
DIALOGDATA_SANCTUMCIVILIAN_00_LOCAL_BRANCH_MAP_HUB_SANCTUM__CLIENTNPCS__NPC_SANCTUMCIVILIAN_GRN__DIALOGTRIGGER_DIALOG_0_INPUT	
DIALOGDATA_SANCTUMCIVILIAN_00_LOCAL_BRANCH_MAP_HUB_SANCTUM__CLIENTNPCS__NPC_SANCTUMCIVILIAN_GRN__DIALOGTRIGGER_DIALOG_0_INPUT_ALT_0	这俩货明显没体验过身轻如燕究竟怎样的感觉。他们能明白该有多好……
DIALOGDATA_SANCTUMCIVILIAN_00_LOCAL_BRANCH_MAP_HUB_SANCTUM__CLIENTNPCS__NPC_SANCTUMCIVILIAN_GRN__DIALOGTRIGGER_DIALOG_0_INPUT_ALT_1	机智与速度，无可匹敌。战士与秘术师，怎敌得过盗贼？
DIALOGDATA_SANCTUMCIVILIAN_00_LOCAL_BRANCH_MAP_HUB_SANCTUM__CLIENTNPCS__NPC_SANCTUMCIVILIAN_GRN__DIALOGTRIGGER_DIALOG_0_INPUT_ALT_2	你见过莎莉了吗？她真的很了不起呢。
DIALOGDATA_SANCTUMCIVILIAN_00_LOCAL_BRANCH_MAP_HUB_SANCTUM__CLIENTNPCS__NPC_SANCTUMCIVILIAN_BLU__DIALOGTRIGGER_DIALOG_0_INPUT	
DIALOGDATA_SANCTUMCIVILIAN_00_LOCAL_BRANCH_MAP_HUB_SANCTUM__CLIENTNPCS__NPC_SANCTUMCIVILIAN_BLU__DIALOGTRIGGER_DIALOG_0_INPUT_ALT_0	很显然！秘术师职业可比其他要高贵多了。
DIALOGDATA_SANCTUMCIVILIAN_00_LOCAL_BRANCH_MAP_HUB_SANCTUM__CLIENTNPCS__NPC_SANCTUMCIVILIAN_BLU__DIALOGTRIGGER_DIALOG_0_INPUT_ALT_1	施法无疑是最优选择，没有任何例外！
DIALOGDATA_SANCTUMCIVILIAN_00_LOCAL_BRANCH_MAP_HUB_SANCTUM__CLIENTNPCS__NPC_SANCTUMCIVILIAN_BLU__DIALOGTRIGGER_DIALOG_0_INPUT_ALT_2	其他人捅了娄子都得靠安琪拉收场！，她比任何人都聪明！
DIALOGDATA_SANCTUMCIVILIAN_00_LOCAL_BRANCH_MAP_HUB_SANCTUM__CLIENTNPCS__NPC_SANCTUMCIVILIAN_BLU__DIALOGTRIGGER_DIALOG_0_INPUT_ALT_3	他们还有很多东西要学…..
DIALOGDATA_SANCTUMCIVILIAN_00_LOCAL_BRANCH_MAP_HUB_SANCTUM__CLIENTNPCS__NPC_SANCTUMCIVILIAN_RED_08__DIALOGTRIGGER_DIALOG_0_INPUT	
DIALOGDATA_SANCTUMCIVILIAN_00_LOCAL_BRANCH_MAP_HUB_SANCTUM__CLIENTNPCS__NPC_SANCTUMCIVILIAN_RED_08__DIALOGTRIGGER_DIALOG_0_INPUT_ALT_0	嘿，欢迎来到兵营。
DIALOGDATA_SANCTUMCIVILIAN_00_LOCAL_BRANCH_MAP_HUB_SANCTUM__CLIENTNPCS__NPC_SANCTUMCIVILIAN_RED_08__DIALOGTRIGGER_DIALOG_0_INPUT_ALT_1	你见过伊诺克了吗？他是战士守护者。
DIALOGDATA_SANCTUMCIVILIAN_00_LOCAL_BRANCH_MAP_HUB_SANCTUM__CLIENTNPCS__NPC_SANCTUMCIVILIAN_RED_08__DIALOGTRIGGER_DIALOG_0_INPUT_ALT_2	我的力量与伊诺克的力量产生共鸣。
DIALOGDATA_SANCTUMCIVILIAN_00_LOCAL_BRANCH_MAP_HUB_SANCTUM__CLIENTNPCS__NPC_SANCTUMCIVILIAN_RED_02__DIALOGTRIGGER_DIALOG_0_INPUT	
DIALOGDATA_SANCTUMCIVILIAN_00_LOCAL_BRANCH_MAP_HUB_SANCTUM__CLIENTNPCS__NPC_SANCTUMCIVILIAN_RED_02__DIALOGTRIGGER_DIALOG_0_INPUT_ALT_0	你好!
DIALOGDATA_SANCTUMCIVILIAN_00_LOCAL_BRANCH_MAP_HUB_SANCTUM__CLIENTNPCS__NPC_SANCTUMCIVILIAN_RED_02__DIALOGTRIGGER_DIALOG_0_INPUT_ALT_1	看起来你并不是这个世界的人。我们是这里的居民，这里永远欢迎你们，流离者。
DIALOGDATA_SANCTUMCIVILIAN_00_LOCAL_BRANCH_MAP_HUB_SANCTUM__CLIENTNPCS__NPC_SANCTUMCIVILIAN_RED_02__DIALOGTRIGGER_DIALOG_0_INPUT_ALT_2	只要你能在这艰难时刻协助我们，这里就可以是你休息的地方！
DIALOGDATA_SANCTUMCIVILIAN_00_LOCAL_BRANCH_MAP_HUB_SANCTUM__CLIENTNPCS__NPC_SANCTUMCIVILIAN_RED_07__DIALOGTRIGGER_DIALOG_0_INPUT	
DIALOGDATA_SANCTUMCIVILIAN_00_LOCAL_BRANCH_MAP_HUB_SANCTUM__CLIENTNPCS__NPC_SANCTUMCIVILIAN_RED_07__DIALOGTRIGGER_DIALOG_0_INPUT_ALT_0	冒险者，欢迎来到我们的兵营。
DIALOGDATA_SANCTUMCIVILIAN_00_LOCAL_BRANCH_MAP_HUB_SANCTUM__CLIENTNPCS__NPC_SANCTUMCIVILIAN_RED_07__DIALOGTRIGGER_DIALOG_0_INPUT_ALT_1	伊诺克大师已经知晓你的到来。别让他失望。
DIALOGDATA_SANCTUMCIVILIAN_00_LOCAL_BRANCH_MAP_HUB_SANCTUM__CLIENTNPCS__NPC_SANCTUMCIVILIAN_RED_07__DIALOGTRIGGER_DIALOG_0_INPUT_ALT_2	真希望现在能去杀几只史莱姆放松一下……
DIALOGDATA_SANCTUMCIVILIAN_00_LOCAL_BRANCH_MAP_HUB_SANCTUM__CLIENTNPCS__NPC_SANCTUMCIVILIAN_RED_04__DIALOGTRIGGER_DIALOG_0_INPUT	
DIALOGDATA_SANCTUMCIVILIAN_00_LOCAL_BRANCH_MAP_HUB_SANCTUM__CLIENTNPCS__NPC_SANCTUMCIVILIAN_RED_04__DIALOGTRIGGER_DIALOG_0_INPUT_ALT_0	外面很危险，我建议你做好准备。
DIALOGDATA_SANCTUMCIVILIAN_00_LOCAL_BRANCH_MAP_HUB_SANCTUM__CLIENTNPCS__NPC_SANCTUMCIVILIAN_RED_04__DIALOGTRIGGER_DIALOG_0_INPUT_ALT_1	提醒一下，只有在与安琪拉对话之后，通往圣地外的传送门才会开启。
DIALOGDATA_SANCTUMCIVILIAN_00_LOCAL_BRANCH_MAP_HUB_SANCTUM__CLIENTNPCS__NPC_SANCTUMCIVILIAN_RED_04__DIALOGTRIGGER_DIALOG_0_INPUT_ALT_2	要是外面的世界像从前那样安全就好了…
DIALOGDATA_SANCTUMCIVILIAN_00_LOCAL_BRANCH_MAP_HUB_SANCTUM__CLIENTNPCS__NPC_SANCTUMCIVILIAN_RED_01__DIALOGTRIGGER_DIALOG_0_INPUT	
DIALOGDATA_SANCTUMCIVILIAN_00_LOCAL_BRANCH_MAP_HUB_SANCTUM__CLIENTNPCS__NPC_SANCTUMCIVILIAN_RED_01__DIALOGTRIGGER_DIALOG_0_INPUT_ALT_0	我们会尽力确保圣地拥有所有必要的物资。
DIALOGDATA_SANCTUMCIVILIAN_00_LOCAL_BRANCH_MAP_HUB_SANCTUM__CLIENTNPCS__NPC_SANCTUMCIVILIAN_RED_01__DIALOGTRIGGER_DIALOG_0_INPUT_ALT_1	我们还剩多少个袋装疗膏？我数不清了……
DIALOGDATA_SANCTUMCIVILIAN_00_LOCAL_BRANCH_MAP_HUB_SANCTUM__CLIENTNPCS__NPC_SANCTUMCIVILIAN_RED_01__DIALOGTRIGGER_DIALOG_0_INPUT_ALT_2	嗯……我应该和莎莉谈谈，确保我们没漏掉什么……
DIALOGDATA_SANCTUMCIVILIAN_00_LOCAL_BRANCH_MAP_HUB_SANCTUM__CLIENTNPCS__NPC_SANCTUMCIVILIAN_RED_01__DIALOGTRIGGER_DIALOG_0_INPUT_ALT_3	唉，胡萝卜蛋糕好像没剩多少了，我超喜欢吃那个的！
DIALOGDATA_SANCTUMCIVILIAN_00_LOCAL_BRANCH_MAP_HUB_SANCTUM__CLIENTNPCS__NPC_SANCTUMCIVILIAN_RED_03__DIALOGTRIGGER_DIALOG_0_INPUT	
DIALOGDATA_SANCTUMCIVILIAN_00_LOCAL_BRANCH_MAP_HUB_SANCTUM__CLIENTNPCS__NPC_SANCTUMCIVILIAN_RED_03__DIALOGTRIGGER_DIALOG_0_INPUT_ALT_0	嘿，旅行者！
DIALOGDATA_SANCTUMCIVILIAN_00_LOCAL_BRANCH_MAP_HUB_SANCTUM__CLIENTNPCS__NPC_SANCTUMCIVILIAN_RED_03__DIALOGTRIGGER_DIALOG_0_INPUT_ALT_1	我打算去练练手，找几个史莱姆打打！
DIALOGDATA_SANCTUMCIVILIAN_00_LOCAL_BRANCH_MAP_HUB_SANCTUM__CLIENTNPCS__NPC_SANCTUMCIVILIAN_RED_03__DIALOGTRIGGER_DIALOG_0_INPUT_ALT_2	虽然我们现在的力量还不足以应对外面的世界，但我决心有一天打破这道壁垒。
DIALOGDATA_SANCTUMCIVILIAN_00_LOCAL_BRANCH_MAP_HUB_SANCTUM__CLIENTNPCS__NPC_SANCTUMCIVILIAN_RED_03__DIALOGTRIGGER_DIALOG_0_INPUT_ALT_3	说实话，我等不及要揍那家伙的屁股了！
DIALOGDATA_SANCTUMCIVILIAN_00_LOCAL_BRANCH_MAP_HUB_SANCTUM__CLIENTNPCS__NPC_SANCTUMCIVILIAN_RED_03__DIALOGTRIGGER_DIALOG_0_INPUT_ALT_4	什么？！你生活的世界不是一直像这样的阴天？
DIALOGDATA_SANCTUMCIVILIAN_00_LOCAL_BRANCH_MAP_HUB_SANCTUM__CLIENTNPCS__NPC_SANCTUMCIVILIAN_RED_06__DIALOGTRIGGER_DIALOG_0_INPUT	
DIALOGDATA_SANCTUMCIVILIAN_00_LOCAL_BRANCH_MAP_HUB_SANCTUM__CLIENTNPCS__NPC_SANCTUMCIVILIAN_RED_06__DIALOGTRIGGER_DIALOG_0_INPUT_ALT_0	你好，冒险者。这是通往圣地外域的入口。
DIALOGDATA_SANCTUMCIVILIAN_00_LOCAL_BRANCH_MAP_HUB_SANCTUM__CLIENTNPCS__NPC_SANCTUMCIVILIAN_RED_06__DIALOGTRIGGER_DIALOG_0_INPUT_ALT_1	我被派驻在这里，守卫圣地，防止任何外来的威胁。
DIALOGDATA_SANCTUMCIVILIAN_00_LOCAL_BRANCH_MAP_HUB_SANCTUM__CLIENTNPCS__NPC_SANCTUMCIVILIAN_RED_06__DIALOGTRIGGER_DIALOG_0_INPUT_ALT_2	嗯…你有多少次机会能证明自己？
DIALOGDATA_SANCTUMCIVILIAN_00_LOCAL_BRANCH_MAP_HUB_SANCTUM__CLIENTNPCS__NPC_SANCTUMCIVILIAN_GRN_01__DIALOGTRIGGER_DIALOG_0_INPUT	
DIALOGDATA_SANCTUMCIVILIAN_00_LOCAL_BRANCH_MAP_HUB_SANCTUM__CLIENTNPCS__NPC_SANCTUMCIVILIAN_GRN_01__DIALOGTRIGGER_DIALOG_0_INPUT_ALT_0	我在想，除了这里，这个世界上还有哪个地方能像这里一样安全呢……
DIALOGDATA_SANCTUMCIVILIAN_00_LOCAL_BRANCH_MAP_HUB_SANCTUM__CLIENTNPCS__NPC_SANCTUMCIVILIAN_GRN_01__DIALOGTRIGGER_DIALOG_0_INPUT_ALT_1	嘿，你去过新月堡垒了吗？传言说那里曾是一个充满自然魔法的神殿。
DIALOGDATA_SANCTUMCIVILIAN_00_LOCAL_BRANCH_MAP_HUB_SANCTUM__CLIENTNPCS__NPC_SANCTUMCIVILIAN_GRN_01__DIALOGTRIGGER_DIALOG_0_INPUT_ALT_2	据说守护者早在我们之前就存在，但.....有人告诉我这并不是真的。
DIALOGDATA_SANCTUMCIVILIAN_00_LOCAL_BRANCH_MAP_HUB_SANCTUM__CLIENTNPCS__NPC_SANCTUMCIVILIAN_GRN_01__DIALOGTRIGGER_DIALOG_0_INPUT_ALT_3	我想知道晚餐吃什么……
DIALOGDATA_SANCTUMCIVILIAN_00_LOCAL_BRANCH_MAP_HUB_WALLOFTHESTARS__LOCALNPC__NPC_SANCTUMCIVILIAN_BLU__DIALOGTRIGGER_DIALOG_0_INPUT	
DIALOGDATA_SANCTUMCIVILIAN_00_LOCAL_BRANCH_MAP_HUB_WALLOFTHESTARS__LOCALNPC__NPC_SANCTUMCIVILIAN_BLU__DIALOGTRIGGER_DIALOG_0_INPUT_ALT_0	这里实在太美了，我不想离开，我决定就留在这里了。
DIALOGDATA_SANCTUMCIVILIAN_00_LOCAL_BRANCH_MAP_HUB_WALLOFTHESTARS__LOCALNPC__NPC_SANCTUMCIVILIAN_BLU__DIALOGTRIGGER_DIALOG_0_INPUT_ALT_1	是你开启了通向这里的传送门的吗？
DIALOGDATA_SANCTUMCIVILIAN_00_LOCAL_BRANCH_MAP_HUB_WALLOFTHESTARS__LOCALNPC__NPC_SANCTUMCIVILIAN_BLU__DIALOGTRIGGER_DIALOG_0_INPUT_ALT_2	真是幸运的一天，安琪拉没有忘记我们！
DIALOGDATA_SANCTUMCIVILIAN_00_LOCAL_BRANCH_MAP_HUB_WALLOFTHESTARS__LOCALNPC__NPC_SANCTUMCIVILIAN_RED_04__DIALOGTRIGGER_DIALOG_0_INPUT	
DIALOGDATA_SANCTUMCIVILIAN_00_LOCAL_BRANCH_MAP_HUB_WALLOFTHESTARS__LOCALNPC__NPC_SANCTUMCIVILIAN_RED_04__DIALOGTRIGGER_DIALOG_0_INPUT_ALT_0	哦？我还以为这里不会再有新面孔出现了。
DIALOGDATA_SANCTUMCIVILIAN_00_LOCAL_BRANCH_MAP_HUB_WALLOFTHESTARS__LOCALNPC__NPC_SANCTUMCIVILIAN_RED_04__DIALOGTRIGGER_DIALOG_0_INPUT_ALT_1	看来传送门已经打开了……谢天谢地！
DIALOGDATA_SANCTUMCIVILIAN_00_LOCAL_BRANCH_MAP_HUB_WALLOFTHESTARS__LOCALNPC__NPC_SANCTUMCIVILIAN_RED_04__DIALOGTRIGGER_DIALOG_0_INPUT_ALT_2	在这里稍作休息再出发吧，要小心！
DIALOGDATA_SANCTUMCIVILIAN_00_LOCAL_BRANCH_MAP_HUB_WALLOFTHESTARS__LOCALNPC__NPC_SANCTUMCIVILIAN_RED_04__DIALOGTRIGGER_DIALOG_0_INPUT_ALT_3	圣地那边怎么样？希望一切都好。
DIALOGDATA_SANCTUMCIVILIAN_00_LOCAL_BRANCH_MAP_HUB_WALLOFTHESTARS__LOCALNPC__NPC_SANCTUMCIVILIAN_GRN__DIALOGTRIGGER_DIALOG_0_INPUT	
DIALOGDATA_SANCTUMCIVILIAN_00_LOCAL_BRANCH_MAP_HUB_WALLOFTHESTARS__LOCALNPC__NPC_SANCTUMCIVILIAN_GRN__DIALOGTRIGGER_DIALOG_0_INPUT_ALT_0	有人说，繁星之壁能在心灵深处低语。
DIALOGDATA_SANCTUMCIVILIAN_00_LOCAL_BRANCH_MAP_HUB_WALLOFTHESTARS__LOCALNPC__NPC_SANCTUMCIVILIAN_GRN__DIALOGTRIGGER_DIALOG_0_INPUT_ALT_1	知道我们不再被困于此，真是太好了…
DIALOGDATA_SANCTUMCIVILIAN_00_LOCAL_BRANCH_MAP_HUB_WALLOFTHESTARS__LOCALNPC__NPC_SANCTUMCIVILIAN_GRN__DIALOGTRIGGER_DIALOG_0_INPUT_ALT_2	我们挺幸运能被困在这里，呃...至少比被困在那些更危险的地方强多了……
DIALOGDATA_SANCTUMCIVILIAN_00_LOCAL_BRANCH_MAP_HUB_WALLOFTHESTARS__LOCALNPC__NPC_SANCTUMCIVILIAN_GRN__DIALOGTRIGGER_DIALOG_0_INPUT_ALT_3	你好，旅行者。
